batter_id,batter,pitches_in_zone,swings_in_zone,whiffs_in_zone,pitches_out_zone,swings_out_zone,whiffs_out_zone,pitches,swings,whiffs,swing_rate,whiff_rate,sw_str_rate,z_rate,z_swing_rate,z_whiff_rate,o_rate,o_swing_rate,o_whiff_rate
501303,Ehire Adrianza,36,18,3,55,18,1,91,36,4,0.3956043956043956,0.1111111111111111,0.04395604395604396,0.3956043956043956,0.5,0.16666666666666666,0.6043956043956044,0.32727272727272727,0.05555555555555555
501659,Abraham Almonte,60,29,7,92,18,7,152,47,14,0.3092105263157895,0.2978723404255319,0.09210526315789473,0.39473684210526316,0.48333333333333334,0.2413793103448276,0.6052631578947368,0.1956521739130435,0.3888888888888889
543510,James McCann,27,15,0,11,0,0,38,15,0,0.39473684210526316,0.0,0.0,0.7105263157894737,0.5555555555555556,0.0,0.2894736842105263,0.0,
553882,Omar Narvaez,10,7,0,16,2,2,26,9,2,0.34615384615384615,0.2222222222222222,0.07692307692307693,0.38461538461538464,0.7,0.0,0.6153846153846154,0.125,1.0
602104,Ramon Urias,21,10,3,29,7,1,50,17,4,0.34,0.23529411764705882,0.08,0.42,0.47619047619047616,0.3,0.58,0.2413793103448276,0.14285714285714285
605244,Aramis Garcia,14,9,4,21,9,4,35,18,8,0.5142857142857142,0.4444444444444444,0.22857142857142856,0.4,0.6428571428571429,0.4444444444444444,0.6,0.42857142857142855,0.4444444444444444
608385,Jesse Winker,27,16,0,31,6,3,58,22,3,0.3793103448275862,0.13636363636363635,0.05172413793103448,0.46551724137931033,0.5925925925925926,0.0,0.5344827586206896,0.1935483870967742,0.5
621532,Anthony Bemboom,16,7,1,11,3,1,27,10,2,0.37037037037037035,0.2,0.07407407407407407,0.5925925925925926,0.4375,0.14285714285714285,0.4074074074074074,0.2727272727272727,0.3333333333333333
622268,Donovan Walton,94,61,18,90,30,8,184,91,26,0.4945652173913043,0.2857142857142857,0.14130434782608695,0.5108695652173914,0.648936170212766,0.29508196721311475,0.4891304347826087,0.3333333333333333,0.26666666666666666
625510,Erick Mejia,71,41,8,71,9,2,142,50,10,0.352112676056338,0.2,0.07042253521126761,0.5,0.5774647887323944,0.1951219512195122,0.5,0.1267605633802817,0.2222222222222222
641487,J.P. Crawford,2,1,0,15,4,1,17,5,1,0.29411764705882354,0.2,0.058823529411764705,0.11764705882352941,0.5,0.0,0.8823529411764706,0.26666666666666666,0.25
641552,Karl Ellison,80,53,16,108,41,21,188,94,37,0.5,0.39361702127659576,0.19680851063829788,0.425531914893617,0.6625,0.3018867924528302,0.574468085106383,0.37962962962962965,0.5121951219512195
641645,Luis Guillorme,6,4,3,7,1,1,13,5,4,0.38461538461538464,0.8,0.3076923076923077,0.46153846153846156,0.6666666666666666,0.75,0.5384615384615384,0.14285714285714285,1.0
641938,Arden Pabst,40,23,4,63,24,10,103,47,14,0.4563106796116505,0.2978723404255319,0.13592233009708737,0.3883495145631068,0.575,0.17391304347826086,0.6116504854368932,0.38095238095238093,0.4166666666666667
642715,Willy Adames,14,7,1,28,9,3,42,16,4,0.38095238095238093,0.25,0.09523809523809523,0.3333333333333333,0.5,0.14285714285714285,0.6666666666666666,0.32142857142857145,0.3333333333333333
647228,Adam Hall,43,28,9,51,11,3,94,39,12,0.4148936170212766,0.3076923076923077,0.1276595744680851,0.4574468085106383,0.6511627906976745,0.32142857142857145,0.5425531914893617,0.21568627450980393,0.2727272727272727
656248,Sean Bouchard,23,14,3,47,11,3,70,25,6,0.35714285714285715,0.24,0.08571428571428572,0.32857142857142857,0.6086956521739131,0.21428571428571427,0.6714285714285714,0.23404255319148937,0.2727272727272727
656537,Derek Hill,19,9,1,27,7,1,46,16,2,0.34782608695652173,0.125,0.043478260869565216,0.41304347826086957,0.47368421052631576,0.1111111111111111,0.5869565217391305,0.25925925925925924,0.14285714285714285
657023,Tim Susnara,97,63,31,109,34,11,206,97,42,0.470873786407767,0.4329896907216495,0.20388349514563106,0.470873786407767,0.6494845360824743,0.49206349206349204,0.529126213592233,0.3119266055045872,0.3235294117647059
659359,Zac Fascia,74,53,16,122,51,21,196,104,37,0.5306122448979592,0.3557692307692308,0.18877551020408162,0.37755102040816324,0.7162162162162162,0.3018867924528302,0.6224489795918368,0.4180327868852459,0.4117647058823529
659435,Max Wright,258,161,44,270,69,31,528,230,75,0.4356060606060606,0.32608695652173914,0.14204545454545456,0.48863636363636365,0.624031007751938,0.2732919254658385,0.5113636363636364,0.25555555555555554,0.4492753623188406
660631,Kevin Vicuna,34,26,4,15,1,1,49,27,5,0.5510204081632653,0.18518518518518517,0.10204081632653061,0.6938775510204082,0.7647058823529411,0.15384615384615385,0.30612244897959184,0.06666666666666667,1.0
661541,Donovan Casey,19,16,0,20,6,2,39,22,2,0.5641025641025641,0.09090909090909091,0.05128205128205128,0.48717948717948717,0.8421052631578947,0.0,0.5128205128205128,0.3,0.3333333333333333
663516,Dillon Paulson,461,258,37,374,96,34,835,354,71,0.4239520958083832,0.20056497175141244,0.08502994011976048,0.5520958083832336,0.559652928416486,0.1434108527131783,0.4479041916167665,0.25668449197860965,0.3541666666666667
663519,Kekai Rios,180,135,25,289,96,39,469,231,64,0.4925373134328358,0.27705627705627706,0.13646055437100213,0.3837953091684435,0.75,0.18518518518518517,0.6162046908315565,0.33217993079584773,0.40625
663600,D.J. Artis,67,25,9,44,10,1,111,35,10,0.3153153153153153,0.2857142857142857,0.09009009009009009,0.6036036036036037,0.373134328358209,0.36,0.3963963963963964,0.22727272727272727,0.1
663682,Mike Salvatore,313,199,42,482,146,38,795,345,80,0.4339622641509434,0.2318840579710145,0.10062893081761007,0.3937106918238994,0.6357827476038339,0.21105527638190955,0.6062893081761006,0.3029045643153527,0.2602739726027397
663714,Matt Kroon,28,14,5,22,4,1,50,18,6,0.36,0.3333333333333333,0.12,0.56,0.5,0.35714285714285715,0.44,0.18181818181818182,0.25
663744,Nick Shumpert,204,133,49,295,101,50,499,234,99,0.46893787575150303,0.4230769230769231,0.19839679358717435,0.4088176352705411,0.6519607843137255,0.3684210526315789,0.591182364729459,0.3423728813559322,0.49504950495049505
663898,Brendan Rodgers,25,19,4,35,5,5,60,24,9,0.4,0.375,0.15,0.4166666666666667,0.76,0.21052631578947367,0.5833333333333334,0.14285714285714285,1.0
664238,Dylan Moore,19,12,0,38,7,3,57,19,3,0.3333333333333333,0.15789473684210525,0.05263157894736842,0.3333333333333333,0.631578947368421,0.0,0.6666666666666666,0.18421052631578946,0.42857142857142855
664762,Andy Atwood,184,133,25,241,106,37,425,239,62,0.5623529411764706,0.2594142259414226,0.14588235294117646,0.4329411764705882,0.7228260869565217,0.18796992481203006,0.5670588235294117,0.43983402489626555,0.3490566037735849
665506,Cristian Pache,12,7,2,34,15,5,46,22,7,0.4782608695652174,0.3181818181818182,0.15217391304347827,0.2608695652173913,0.5833333333333334,0.2857142857142857,0.7391304347826086,0.4411764705882353,0.3333333333333333
665561,Rafael Marchan,29,14,1,21,7,1,50,21,2,0.42,0.09523809523809523,0.04,0.58,0.4827586206896552,0.07142857142857142,0.42,0.3333333333333333,0.14285714285714285
665650,Lucius Fox,70,37,12,101,47,11,171,84,23,0.49122807017543857,0.27380952380952384,0.13450292397660818,0.4093567251461988,0.5285714285714286,0.32432432432432434,0.5906432748538012,0.46534653465346537,0.23404255319148937
665888,Cristopher Navarro,46,32,4,55,15,8,101,47,12,0.46534653465346537,0.2553191489361702,0.1188118811881188,0.45544554455445546,0.6956521739130435,0.125,0.5445544554455446,0.2727272727272727,0.5333333333333333
665908,Eduardo Torrealba,231,138,26,297,80,27,528,218,53,0.4128787878787879,0.24311926605504589,0.10037878787878787,0.4375,0.5974025974025974,0.18840579710144928,0.5625,0.26936026936026936,0.3375
665989,Shervyen Newton,788,481,149,660,210,94,1448,691,243,0.47720994475138123,0.3516642547033285,0.16781767955801105,0.5441988950276243,0.6104060913705583,0.3097713097713098,0.4558011049723757,0.3181818181818182,0.44761904761904764
666194,Cooper Johnson,200,119,30,409,146,55,609,265,85,0.4351395730706076,0.32075471698113206,0.13957307060755336,0.3284072249589491,0.595,0.25210084033613445,0.6715927750410509,0.3569682151589242,0.3767123287671233
666198,Carter Kieboom,27,17,4,46,15,3,73,32,7,0.4383561643835616,0.21875,0.0958904109589041,0.3698630136986301,0.6296296296296297,0.23529411764705882,0.6301369863013698,0.32608695652173914,0.2
666695,Jonathan Guzman,129,84,19,234,79,32,363,163,51,0.4490358126721763,0.3128834355828221,0.14049586776859505,0.35537190082644626,0.6511627906976745,0.2261904761904762,0.6446280991735537,0.33760683760683763,0.4050632911392405
666906,Jake Alu,33,23,5,30,5,2,63,28,7,0.4444444444444444,0.25,0.1111111111111111,0.5238095238095238,0.696969696969697,0.21739130434782608,0.47619047619047616,0.16666666666666666,0.4
667240,Jason Matthews,167,91,19,258,70,27,425,161,46,0.3788235294117647,0.2857142857142857,0.10823529411764705,0.39294117647058824,0.5449101796407185,0.2087912087912088,0.6070588235294118,0.2713178294573643,0.38571428571428573
667727,Steele Walker,164,126,21,113,16,6,277,142,27,0.5126353790613718,0.19014084507042253,0.09747292418772563,0.592057761732852,0.7682926829268293,0.16666666666666666,0.40794223826714804,0.1415929203539823,0.375
667803,Ernesto Martinez,416,280,69,588,201,67,1004,481,136,0.47908366533864544,0.28274428274428276,0.13545816733067728,0.41434262948207173,0.6730769230769231,0.24642857142857144,0.5856573705179283,0.34183673469387754,0.3333333333333333
668558,Juan Zabala,277,204,51,348,95,31,625,299,82,0.4784,0.27424749163879597,0.1312,0.4432,0.7364620938628159,0.25,0.5568,0.27298850574712646,0.3263157894736842
668577,Osmy Gregorio,539,362,75,504,149,54,1043,511,129,0.4899328859060403,0.25244618395303325,0.1236816874400767,0.5167785234899329,0.6716141001855288,0.20718232044198895,0.48322147651006714,0.29563492063492064,0.3624161073825503
668756,Ben Ramirez,894,578,151,1108,371,130,2002,949,281,0.474025974025974,0.29610115911485774,0.14035964035964035,0.44655344655344653,0.6465324384787472,0.26124567474048443,0.5534465534465535,0.3348375451263538,0.3504043126684636
668769,Cam Williams,146,117,36,135,62,35,281,179,71,0.6370106761565836,0.39664804469273746,0.2526690391459075,0.5195729537366548,0.8013698630136986,0.3076923076923077,0.4804270462633452,0.45925925925925926,0.5645161290322581
668776,Devin Ortiz,77,57,16,111,35,18,188,92,34,0.48936170212765956,0.3695652173913043,0.18085106382978725,0.4095744680851064,0.7402597402597403,0.2807017543859649,0.5904255319148937,0.3153153153153153,0.5142857142857142
668787,Bryce Ball,262,171,46,277,73,27,539,244,73,0.45269016697588127,0.29918032786885246,0.13543599257884972,0.48608534322820035,0.6526717557251909,0.26900584795321636,0.5139146567717996,0.26353790613718414,0.3698630136986301
668794,Straton Podaras,41,22,7,33,9,7,74,31,14,0.4189189189189189,0.45161290322580644,0.1891891891891892,0.5540540540540541,0.5365853658536586,0.3181818181818182,0.44594594594594594,0.2727272727272727,0.7777777777777778
668824,Logan Wyatt,401,238,64,509,148,34,910,386,98,0.42417582417582417,0.2538860103626943,0.1076923076923077,0.44065934065934065,0.5935162094763092,0.2689075630252101,0.5593406593406594,0.2907662082514735,0.22972972972972974
668860,Kale Emshoff,638,454,144,710,240,107,1348,694,251,0.5148367952522255,0.361671469740634,0.18620178041543026,0.4732937685459941,0.7115987460815048,0.31718061674008813,0.526706231454006,0.3380281690140845,0.44583333333333336
668882,Mikey Perez,61,40,10,100,29,10,161,69,20,0.42857142857142855,0.2898550724637681,0.12422360248447205,0.37888198757763975,0.6557377049180327,0.25,0.6211180124223602,0.29,0.3448275862068966
668883,Steven Williams,22,10,1,26,3,1,48,13,2,0.2708333333333333,0.15384615384615385,0.041666666666666664,0.4583333333333333,0.45454545454545453,0.1,0.5416666666666666,0.11538461538461539,0.3333333333333333
668952,Ryan Kreidler,25,17,3,51,20,10,76,37,13,0.4868421052631579,0.35135135135135137,0.17105263157894737,0.32894736842105265,0.68,0.17647058823529413,0.6710526315789473,0.39215686274509803,0.5
668993,Justin Farmer,385,272,74,596,179,64,981,451,138,0.4597349643221203,0.30598669623059865,0.14067278287461774,0.3924566768603466,0.7064935064935065,0.27205882352941174,0.6075433231396534,0.30033557046979864,0.3575418994413408
669010,Elijah Cabell,214,137,56,324,105,72,538,242,128,0.44981412639405205,0.5289256198347108,0.2379182156133829,0.39776951672862454,0.6401869158878505,0.40875912408759124,0.6022304832713755,0.32407407407407407,0.6857142857142857
669013,Gary Mattis,265,208,53,407,177,83,672,385,136,0.5729166666666666,0.35324675324675325,0.20238095238095238,0.3943452380952381,0.7849056603773585,0.2548076923076923,0.6056547619047619,0.4348894348894349,0.4689265536723164
669015,Caberea Weaver,327,228,66,449,174,86,776,402,152,0.5180412371134021,0.3781094527363184,0.1958762886597938,0.4213917525773196,0.6972477064220184,0.2894736842105263,0.5786082474226805,0.38752783964365256,0.4942528735632184
669023,Jeter Downs,15,2,0,42,14,7,57,16,7,0.2807017543859649,0.4375,0.12280701754385964,0.2631578947368421,0.13333333333333333,0.0,0.7368421052631579,0.3333333333333333,0.5
669065,Kyle Stowers,23,15,2,43,27,5,66,42,7,0.6363636363636364,0.16666666666666666,0.10606060606060606,0.3484848484848485,0.6521739130434783,0.13333333333333333,0.6515151515151515,0.627906976744186,0.18518518518518517
669190,Cuba Bess,121,94,22,136,44,26,257,138,48,0.5369649805447471,0.34782608695652173,0.1867704280155642,0.4708171206225681,0.7768595041322314,0.23404255319148937,0.5291828793774319,0.3235294117647059,0.5909090909090909
669218,Kier Meredith,143,78,22,230,71,21,373,149,43,0.39946380697050937,0.28859060402684567,0.11528150134048257,0.38337801608579086,0.5454545454545454,0.28205128205128205,0.6166219839142091,0.30869565217391304,0.29577464788732394
669219,Je'Von Ward,492,305,80,645,178,65,1137,483,145,0.42480211081794195,0.3002070393374741,0.12752858399296393,0.43271767810026385,0.6199186991869918,0.26229508196721313,0.5672823218997362,0.27596899224806204,0.3651685393258427
669227,Kendall Simmons,373,216,61,463,120,37,836,336,98,0.4019138755980861,0.2916666666666667,0.11722488038277512,0.4461722488038278,0.579088471849866,0.2824074074074074,0.5538277511961722,0.2591792656587473,0.30833333333333335
669327,Tanner Allen,415,274,43,546,203,54,961,477,97,0.4963579604578564,0.20335429769392033,0.10093652445369407,0.43184183142559834,0.6602409638554216,0.15693430656934307,0.5681581685744017,0.3717948717948718,0.2660098522167488
669336,Joe Gray Jr.,680,491,133,1038,394,139,1718,885,272,0.5151338766006985,0.3073446327683616,0.15832363213038417,0.3958090803259604,0.7220588235294118,0.2708757637474542,0.6041909196740396,0.37957610789980734,0.35279187817258884
669347,David Avitia,20,13,6,24,11,6,44,24,12,0.5454545454545454,0.5,0.2727272727272727,0.45454545454545453,0.65,0.46153846153846156,0.5454545454545454,0.4583333333333333,0.5454545454545454
669398,Gage Workman,398,265,72,339,107,45,737,372,117,0.5047489823609227,0.31451612903225806,0.1587516960651289,0.5400271370420624,0.6658291457286433,0.27169811320754716,0.4599728629579376,0.31563421828908556,0.4205607476635514
669413,Frainyer Chavez,274,179,42,430,140,49,704,319,91,0.453125,0.2852664576802508,0.12926136363636365,0.38920454545454547,0.6532846715328468,0.2346368715083799,0.6107954545454546,0.32558139534883723,0.35
669439,Drew Swift,66,37,7,52,9,4,118,46,11,0.3898305084745763,0.2391304347826087,0.09322033898305085,0.559322033898305,0.5606060606060606,0.1891891891891892,0.4406779661016949,0.17307692307692307,0.4444444444444444
669470,Paxton Wallace,266,174,33,313,120,39,579,294,72,0.5077720207253886,0.24489795918367346,0.12435233160621761,0.459412780656304,0.6541353383458647,0.1896551724137931,0.540587219343696,0.38338658146964855,0.325
669475,Troy Claunch,50,34,9,86,30,7,136,64,16,0.47058823529411764,0.25,0.11764705882352941,0.36764705882352944,0.68,0.2647058823529412,0.6323529411764706,0.3488372093023256,0.23333333333333334
669649,Ty Duvall,5,5,1,6,3,2,11,8,3,0.7272727272727273,0.375,0.2727272727272727,0.45454545454545453,1.0,0.2,0.5454545454545454,0.5,0.6666666666666666
670076,Lyle Lin,151,106,24,215,77,29,366,183,53,0.5,0.2896174863387978,0.1448087431693989,0.412568306010929,0.7019867549668874,0.22641509433962265,0.587431693989071,0.3581395348837209,0.37662337662337664
670250,Eli Wilson,193,119,20,295,111,27,488,230,47,0.4713114754098361,0.20434782608695654,0.09631147540983606,0.39549180327868855,0.616580310880829,0.16806722689075632,0.6045081967213115,0.376271186440678,0.24324324324324326
670399,Jeffry Parra,216,131,28,428,151,41,644,282,69,0.43788819875776397,0.24468085106382978,0.10714285714285714,0.33540372670807456,0.6064814814814815,0.21374045801526717,0.6645962732919255,0.352803738317757,0.271523178807947
670548,Jose Mena,100,86,18,142,50,16,242,136,34,0.5619834710743802,0.25,0.14049586776859505,0.4132231404958678,0.86,0.20930232558139536,0.5867768595041323,0.352112676056338,0.32
670860,Lazaro Armenteros,143,75,32,100,24,10,243,99,42,0.4074074074074074,0.42424242424242425,0.1728395061728395,0.588477366255144,0.5244755244755245,0.4266666666666667,0.411522633744856,0.24,0.4166666666666667
670868,Abrahan Gutierrez,139,83,9,186,47,15,325,130,24,0.4,0.18461538461538463,0.07384615384615385,0.4276923076923077,0.5971223021582733,0.10843373493975904,0.5723076923076923,0.25268817204301075,0.3191489361702128
670919,Luis Santana,111,71,14,140,41,16,251,112,30,0.44621513944223107,0.26785714285714285,0.11952191235059761,0.44223107569721115,0.6396396396396397,0.19718309859154928,0.5577689243027888,0.29285714285714287,0.3902439024390244
671117,Darren Baker,38,15,0,52,18,6,90,33,6,0.36666666666666664,0.18181818181818182,0.06666666666666667,0.4222222222222222,0.39473684210526316,0.0,0.5777777777777777,0.34615384615384615,0.3333333333333333
671265,Freudis Nova,276,170,31,356,133,43,632,303,74,0.47943037974683544,0.24422442244224424,0.11708860759493671,0.43670886075949367,0.6159420289855072,0.18235294117647058,0.5632911392405063,0.37359550561797755,0.3233082706766917
671276,Yasel Antuna,142,83,31,152,52,17,294,135,48,0.45918367346938777,0.35555555555555557,0.16326530612244897,0.48299319727891155,0.5845070422535211,0.37349397590361444,0.5170068027210885,0.34210526315789475,0.3269230769230769
671284,Tim Elko,178,109,27,342,140,46,520,249,73,0.47884615384615387,0.2931726907630522,0.14038461538461539,0.3423076923076923,0.6123595505617978,0.24770642201834864,0.6576923076923077,0.4093567251461988,0.32857142857142857
671495,Channy Ortiz,478,345,51,608,164,42,1086,509,93,0.4686924493554328,0.18271119842829076,0.0856353591160221,0.44014732965009207,0.7217573221757322,0.14782608695652175,0.5598526703499079,0.26973684210526316,0.25609756097560976
671748,Casey Yamauchi,8,7,0,19,5,2,27,12,2,0.4444444444444444,0.16666666666666666,0.07407407407407407,0.2962962962962963,0.875,0.0,0.7037037037037037,0.2631578947368421,0.4
671925,Matt Coutney,402,275,73,351,109,51,753,384,124,0.5099601593625498,0.3229166666666667,0.1646746347941567,0.5338645418326693,0.6840796019900498,0.26545454545454544,0.46613545816733065,0.31054131054131057,0.46788990825688076
672013,T.J. Schofield-Sam,346,226,50,229,77,30,575,303,80,0.5269565217391304,0.264026402640264,0.1391304347826087,0.6017391304347826,0.653179190751445,0.22123893805309736,0.3982608695652174,0.33624454148471616,0.38961038961038963
672018,Dasan Brown,736,462,96,1015,300,109,1751,762,205,0.4351798972015991,0.2690288713910761,0.11707595659623073,0.42033123929183325,0.6277173913043478,0.2077922077922078,0.5796687607081668,0.2955665024630542,0.36333333333333334
672357,Jordy Barley,316,217,76,461,157,65,777,374,141,0.48133848133848134,0.3770053475935829,0.18146718146718147,0.4066924066924067,0.6867088607594937,0.35023041474654376,0.5933075933075933,0.3405639913232104,0.4140127388535032
672373,Jeferson Morales,345,247,52,365,118,49,710,365,101,0.5140845070422535,0.27671232876712326,0.14225352112676057,0.4859154929577465,0.7159420289855073,0.21052631578947367,0.5140845070422535,0.3232876712328767,0.4152542372881356
672479,Aldenis Sanchez,430,292,72,592,207,79,1022,499,151,0.4882583170254403,0.3026052104208417,0.14774951076320939,0.4207436399217221,0.6790697674418604,0.2465753424657534,0.5792563600782779,0.34966216216216217,0.38164251207729466
672504,Luis Yanel Diaz,444,328,90,607,235,133,1051,563,223,0.5356803044719315,0.3960923623445826,0.21217887725975262,0.4224548049476689,0.7387387387387387,0.27439024390243905,0.5775451950523312,0.3871499176276771,0.5659574468085107
672537,Dalvy Rosario,378,262,70,447,177,69,825,439,139,0.5321212121212121,0.31662870159453305,0.1684848484848485,0.4581818181818182,0.6931216931216931,0.26717557251908397,0.5418181818181819,0.3959731543624161,0.3898305084745763
672562,Yenci Pena,33,25,5,89,45,20,122,70,25,0.5737704918032787,0.35714285714285715,0.20491803278688525,0.27049180327868855,0.7575757575757576,0.2,0.7295081967213115,0.5056179775280899,0.4444444444444444
672566,Jose Sanchez,181,94,18,340,135,40,521,229,58,0.43953934740882916,0.25327510917030566,0.11132437619961612,0.3474088291746641,0.5193370165745856,0.19148936170212766,0.6525911708253359,0.39705882352941174,0.2962962962962963
672569,Gustavo Campero,459,339,80,418,99,35,877,438,115,0.49942987457240595,0.2625570776255708,0.13112884834663627,0.5233751425313569,0.738562091503268,0.2359882005899705,0.4766248574686431,0.23684210526315788,0.35353535353535354
672600,Claudio Finol,4,4,0,4,0,0,8,4,0,0.5,0.0,0.0,0.5,1.0,0.0,0.5,0.0,
672613,Eliezer Alfonzo,779,529,53,632,178,37,1411,707,90,0.5010630758327428,0.1272984441301273,0.06378454996456413,0.5520907158043941,0.6790757381258024,0.1001890359168242,0.44790928419560594,0.28164556962025317,0.20786516853932585
672623,Esney Chacon,88,53,11,101,29,18,189,82,29,0.43386243386243384,0.35365853658536583,0.15343915343915343,0.4656084656084656,0.6022727272727273,0.20754716981132076,0.5343915343915344,0.2871287128712871,0.6206896551724138
672628,Alexander Campos,202,99,19,184,31,6,386,130,25,0.33678756476683935,0.19230769230769232,0.06476683937823834,0.5233160621761658,0.4900990099009901,0.1919191919191919,0.47668393782383417,0.16847826086956522,0.1935483870967742
672656,Abiezel Ramirez,22,17,5,35,10,4,57,27,9,0.47368421052631576,0.3333333333333333,0.15789473684210525,0.38596491228070173,0.7727272727272727,0.29411764705882354,0.6140350877192983,0.2857142857142857,0.4
672696,Francisco Acuna,163,104,19,336,124,25,499,228,44,0.45691382765531063,0.19298245614035087,0.08817635270541083,0.32665330661322645,0.6380368098159509,0.18269230769230768,0.6733466933867736,0.36904761904761907,0.20161290322580644
672744,Alexander Canario,87,63,15,95,22,15,182,85,30,0.46703296703296704,0.35294117647058826,0.16483516483516483,0.47802197802197804,0.7241379310344828,0.23809523809523808,0.521978021978022,0.23157894736842105,0.6818181818181818
672749,Angel Aponte,178,120,34,379,165,60,557,285,94,0.5116696588868941,0.3298245614035088,0.1687612208258528,0.31956912028725315,0.6741573033707865,0.2833333333333333,0.6804308797127468,0.43535620052770446,0.36363636363636365
672760,Nerio Rodriguez,31,24,8,52,8,4,83,32,12,0.3855421686746988,0.375,0.14457831325301204,0.37349397590361444,0.7741935483870968,0.3333333333333333,0.6265060240963856,0.15384615384615385,0.5
672775,Ghordy Santos,565,363,127,705,204,106,1270,567,233,0.4464566929133858,0.4109347442680776,0.18346456692913385,0.4448818897637795,0.6424778761061947,0.349862258953168,0.5551181102362205,0.28936170212765955,0.5196078431372549
672826,Kenneth Betancourt,263,178,33,196,66,25,459,244,58,0.5315904139433552,0.23770491803278687,0.12636165577342048,0.5729847494553377,0.6768060836501901,0.1853932584269663,0.42701525054466233,0.336734693877551,0.3787878787878788
672832,Israel Pineda,47,36,10,99,48,19,146,84,29,0.5753424657534246,0.34523809523809523,0.19863013698630136,0.3219178082191781,0.7659574468085106,0.2777777777777778,0.678082191780822,0.48484848484848486,0.3958333333333333
672850,Jorge Caballero,240,162,39,334,85,43,574,247,82,0.43031358885017423,0.3319838056680162,0.14285714285714285,0.4181184668989547,0.675,0.24074074074074073,0.5818815331010453,0.25449101796407186,0.5058823529411764
672861,Carlos Luis,631,463,76,702,254,84,1333,717,160,0.5378844711177795,0.22315202231520223,0.12003000750187547,0.47336834208552137,0.7337559429477021,0.16414686825053995,0.5266316579144786,0.36182336182336183,0.33070866141732286
672882,Ismael Alcantara,257,178,42,358,131,58,615,309,100,0.5024390243902439,0.32362459546925565,0.16260162601626016,0.41788617886178864,0.6926070038910506,0.23595505617977527,0.5821138211382114,0.3659217877094972,0.44274809160305345
672903,Wilmer Perez,38,28,7,64,26,7,102,54,14,0.5294117647058824,0.25925925925925924,0.13725490196078433,0.37254901960784315,0.7368421052631579,0.25,0.6274509803921569,0.40625,0.2692307692307692
673045,Josue Huma,92,40,9,65,12,2,157,52,11,0.33121019108280253,0.21153846153846154,0.07006369426751592,0.5859872611464968,0.43478260869565216,0.225,0.4140127388535032,0.18461538461538463,0.16666666666666666
673062,Jarryd Dale,67,50,16,84,33,12,151,83,28,0.5496688741721855,0.3373493975903614,0.18543046357615894,0.44370860927152317,0.746268656716418,0.32,0.5562913907284768,0.39285714285714285,0.36363636363636365
673064,Alex Hall,561,389,112,609,192,82,1170,581,194,0.4965811965811966,0.33390705679862304,0.1658119658119658,0.4794871794871795,0.6934046345811051,0.2879177377892031,0.5205128205128206,0.31527093596059114,0.4270833333333333
673145,Geraldi Diaz,102,55,19,176,74,30,278,129,49,0.46402877697841727,0.3798449612403101,0.17625899280575538,0.3669064748201439,0.5392156862745098,0.34545454545454546,0.6330935251798561,0.42045454545454547,0.40540540540540543
673817,Wiston Cerrato,4,4,1,8,5,4,12,9,5,0.75,0.5555555555555556,0.4166666666666667,0.3333333333333333,1.0,0.25,0.6666666666666666,0.625,0.8
673901,Vaun Brown,27,15,6,55,26,10,82,41,16,0.5,0.3902439024390244,0.1951219512195122,0.32926829268292684,0.5555555555555556,0.4,0.6707317073170732,0.4727272727272727,0.38461538461538464
674630,AJ Lewis,530,318,63,625,127,68,1155,445,131,0.3852813852813853,0.2943820224719101,0.11341991341991342,0.4588744588744589,0.6,0.19811320754716982,0.5411255411255411,0.2032,0.5354330708661418
674976,Griffin Lockwood-Powell,713,440,59,971,175,79,1684,615,138,0.3652019002375297,0.22439024390243903,0.08194774346793349,0.42339667458432306,0.6171107994389902,0.1340909090909091,0.5766033254156769,0.18022657054582905,0.4514285714285714
675430,CJ Rodriguez,575,369,72,471,109,38,1046,478,110,0.4569789674952199,0.2301255230125523,0.10516252390057361,0.5497131931166348,0.6417391304347826,0.1951219512195122,0.4502868068833652,0.23142250530785563,0.3486238532110092
675455,Milan Tolentino,461,274,50,698,249,87,1159,523,137,0.451251078515962,0.26195028680688337,0.1182053494391717,0.39775668679896464,0.5943600867678959,0.18248175182481752,0.6022433132010354,0.35673352435530087,0.3493975903614458
675625,Ivan Gonzalez,183,107,11,294,87,26,477,194,37,0.40670859538784065,0.19072164948453607,0.07756813417190776,0.3836477987421384,0.5846994535519126,0.102803738317757,0.6163522012578616,0.29591836734693877,0.2988505747126437
675974,Kevin Kendall,233,152,34,256,85,35,489,237,69,0.48466257668711654,0.2911392405063291,0.1411042944785276,0.47648261758691207,0.6523605150214592,0.2236842105263158,0.523517382413088,0.33203125,0.4117647058823529
675992,Shane Muntz,392,268,56,632,223,101,1024,491,157,0.4794921875,0.319755600814664,0.1533203125,0.3828125,0.6836734693877551,0.208955223880597,0.6171875,0.3528481012658228,0.452914798206278
675994,Devonte Brown,535,323,66,895,225,91,1430,548,157,0.3832167832167832,0.2864963503649635,0.10979020979020979,0.3741258741258741,0.6037383177570094,0.2043343653250774,0.6258741258741258,0.25139664804469275,0.40444444444444444
676002,Juan Carlos Negret,775,561,178,995,366,165,1770,927,343,0.523728813559322,0.37001078748651567,0.19378531073446328,0.4378531073446328,0.7238709677419355,0.3172905525846702,0.5621468926553672,0.3678391959798995,0.45081967213114754
676004,Walking Cabrera,436,306,84,649,218,96,1085,524,180,0.48294930875576036,0.3435114503816794,0.16589861751152074,0.40184331797235023,0.7018348623853211,0.27450980392156865,0.5981566820276498,0.3359013867488444,0.44036697247706424
676016,Bryant Quijada,210,134,14,256,57,20,466,191,34,0.40987124463519314,0.17801047120418848,0.07296137339055794,0.45064377682403434,0.638095238095238,0.1044776119402985,0.5493562231759657,0.22265625,0.3508771929824561
676017,Micael Ramirez,178,116,18,326,96,23,504,212,41,0.42063492063492064,0.19339622641509435,0.08134920634920635,0.3531746031746032,0.651685393258427,0.15517241379310345,0.6468253968253969,0.294478527607362,0.23958333333333334
676021,Luis Santos,241,143,34,338,100,36,579,243,70,0.41968911917098445,0.2880658436213992,0.12089810017271158,0.4162348877374784,0.5933609958506224,0.23776223776223776,0.5837651122625216,0.2958579881656805,0.36
676044,Bob Seymour,384,269,89,593,235,88,977,504,177,0.5158648925281474,0.35119047619047616,0.1811668372569089,0.3930399181166837,0.7005208333333334,0.3308550185873606,0.6069600818833163,0.3962900505902192,0.37446808510638296
676045,Casey Martin,369,263,77,437,126,50,806,389,127,0.4826302729528536,0.3264781491002571,0.1575682382133995,0.45781637717121587,0.7127371273712737,0.29277566539923955,0.5421836228287841,0.28832951945080093,0.3968253968253968
676053,Casey Opitz,292,176,56,324,84,30,616,260,86,0.42207792207792205,0.33076923076923076,0.1396103896103896,0.474025974025974,0.6027397260273972,0.3181818181818182,0.525974025974026,0.25925925925925924,0.35714285714285715
676155,Will Frizzell,554,296,88,695,216,68,1249,512,156,0.4099279423538831,0.3046875,0.12489991993594876,0.4435548438751001,0.5342960288808665,0.2972972972972973,0.5564451561248999,0.3107913669064748,0.3148148148148148
676203,Marcos Castanon,509,365,70,682,222,75,1191,587,145,0.49286314021830396,0.24701873935264054,0.12174643157010916,0.42737195633921077,0.7170923379174853,0.1917808219178082,0.5726280436607892,0.3255131964809384,0.33783783783783783
676263,Jack Dreyer,9,4,0,3,0,0,12,4,0,0.3333333333333333,0.0,0.0,0.75,0.4444444444444444,0.0,0.25,0.0,
676419,Randy Bednar,267,200,58,469,202,108,736,402,166,0.5461956521739131,0.4129353233830846,0.22554347826086957,0.36277173913043476,0.7490636704119851,0.29,0.6372282608695652,0.43070362473347545,0.5346534653465347
676425,Julio Carrion,22,17,4,44,15,5,66,32,9,0.48484848484848486,0.28125,0.13636363636363635,0.3333333333333333,0.7727272727272727,0.23529411764705882,0.6666666666666666,0.3409090909090909,0.3333333333333333
676466,Jack Winkler,683,445,91,516,116,56,1199,561,147,0.46788990825688076,0.2620320855614973,0.12260216847372811,0.5696413678065054,0.6515373352855052,0.20449438202247192,0.4303586321934946,0.2248062015503876,0.4827586206896552
676509,Josh Crouch,542,421,108,513,176,77,1055,597,185,0.5658767772511848,0.3098827470686767,0.17535545023696683,0.5137440758293839,0.7767527675276753,0.25653206650831356,0.48625592417061614,0.34307992202729043,0.4375
676545,Anthony Servideo,119,61,21,126,39,18,245,100,39,0.40816326530612246,0.39,0.15918367346938775,0.4857142857142857,0.5126050420168067,0.3442622950819672,0.5142857142857142,0.30952380952380953,0.46153846153846156
676566,Shawn Ross,258,141,47,624,196,88,882,337,135,0.3820861678004535,0.40059347181008903,0.15306122448979592,0.2925170068027211,0.5465116279069767,0.3333333333333333,0.7074829931972789,0.3141025641025641,0.4489795918367347
676613,Tyler Esplin,19,8,1,51,21,4,70,29,5,0.4142857142857143,0.1724137931034483,0.07142857142857142,0.2714285714285714,0.42105263157894735,0.125,0.7285714285714285,0.4117647058823529,0.19047619047619047
676812,Carson McCusker,145,91,31,179,60,25,324,151,56,0.4660493827160494,0.3708609271523179,0.1728395061728395,0.44753086419753085,0.6275862068965518,0.34065934065934067,0.5524691358024691,0.33519553072625696,0.4166666666666667
676973,Joe Donovan,287,188,47,414,139,54,701,327,101,0.4664764621968616,0.308868501529052,0.14407988587731813,0.4094151212553495,0.6550522648083623,0.25,0.5905848787446505,0.3357487922705314,0.38848920863309355
676991,Davis Bradshaw,543,362,48,529,186,48,1072,548,96,0.5111940298507462,0.17518248175182483,0.08955223880597014,0.5065298507462687,0.6666666666666666,0.13259668508287292,0.49347014925373134,0.3516068052930057,0.25806451612903225
677004,Steven Rivas,258,193,61,223,81,42,481,274,103,0.5696465696465697,0.3759124087591241,0.21413721413721415,0.5363825363825364,0.748062015503876,0.3160621761658031,0.46361746361746364,0.3632286995515695,0.5185185185185185
677007,Josh Breaux,101,80,30,86,28,10,187,108,40,0.5775401069518716,0.37037037037037035,0.21390374331550802,0.5401069518716578,0.7920792079207921,0.375,0.45989304812834225,0.32558139534883723,0.35714285714285715
677049,Josh Hatcher,287,218,66,435,194,77,722,412,143,0.5706371191135734,0.3470873786407767,0.19806094182825484,0.3975069252077562,0.759581881533101,0.30275229357798167,0.6024930747922438,0.4459770114942529,0.39690721649484534
677295,Micah Bello,56,39,13,117,53,18,173,92,31,0.5317919075144508,0.33695652173913043,0.1791907514450867,0.3236994219653179,0.6964285714285714,0.3333333333333333,0.6763005780346821,0.452991452991453,0.33962264150943394
677319,Cameron Barstad,291,216,57,393,131,66,684,347,123,0.5073099415204678,0.35446685878962536,0.17982456140350878,0.42543859649122806,0.7422680412371134,0.2638888888888889,0.5745614035087719,0.3333333333333333,0.5038167938931297
677341,Osiris Johnson,395,294,87,552,227,103,947,521,190,0.5501583949313622,0.3646833013435701,0.2006335797254488,0.4171066525871172,0.7443037974683544,0.29591836734693877,0.5828933474128828,0.411231884057971,0.45374449339207046
677342,Brock Jones,659,416,164,782,264,107,1441,680,271,0.4718945176960444,0.3985294117647059,0.18806384455239417,0.4573213046495489,0.6312594840667678,0.3942307692307692,0.5426786953504511,0.3375959079283887,0.4053030303030303
677356,Carter Young,122,86,34,116,45,20,238,131,54,0.5504201680672269,0.4122137404580153,0.226890756302521,0.5126050420168067,0.7049180327868853,0.3953488372093023,0.48739495798319327,0.3879310344827586,0.4444444444444444
677565,Kristian Robinson,53,32,15,102,36,13,155,68,28,0.43870967741935485,0.4117647058823529,0.18064516129032257,0.3419354838709677,0.6037735849056604,0.46875,0.6580645161290323,0.35294117647058826,0.3611111111111111
677572,Alvaro Gonzalez,9,5,1,12,4,3,21,9,4,0.42857142857142855,0.4444444444444444,0.19047619047619047,0.42857142857142855,0.5555555555555556,0.2,0.5714285714285714,0.3333333333333333,0.75
677577,Ynmanol Marinez,416,284,52,633,229,124,1049,513,176,0.4890371782650143,0.34307992202729043,0.16777883698760723,0.3965681601525262,0.6826923076923077,0.18309859154929578,0.6034318398474738,0.3617693522906793,0.5414847161572053
677581,Cesar Idrogo,159,100,20,177,59,18,336,159,38,0.4732142857142857,0.2389937106918239,0.1130952380952381,0.4732142857142857,0.6289308176100629,0.2,0.5267857142857143,0.3333333333333333,0.3050847457627119
677593,Luis Garcia,345,190,46,340,76,38,685,266,84,0.3883211678832117,0.3157894736842105,0.12262773722627737,0.5036496350364964,0.5507246376811594,0.24210526315789474,0.49635036496350365,0.2235294117647059,0.5
677601,Keyber Rodriguez,407,278,43,767,340,93,1174,618,136,0.5264054514480409,0.22006472491909385,0.11584327086882454,0.34667802385008517,0.683046683046683,0.15467625899280577,0.6533219761499148,0.44328552803129073,0.2735294117647059
677605,Luis Verdugo,416,239,27,568,164,39,984,403,66,0.4095528455284553,0.16377171215880892,0.06707317073170732,0.42276422764227645,0.5745192307692307,0.11297071129707113,0.5772357723577236,0.2887323943661972,0.23780487804878048
677610,D'Shawn Knowles,867,593,151,752,213,74,1619,806,225,0.4978381717109327,0.27915632754342434,0.13897467572575664,0.535515750463249,0.6839677047289504,0.25463743676222594,0.4644842495367511,0.28324468085106386,0.3474178403755869
677628,Luis Rodriguez,136,110,25,227,107,52,363,217,77,0.5977961432506887,0.3548387096774194,0.21212121212121213,0.3746556473829201,0.8088235294117647,0.22727272727272727,0.6253443526170799,0.4713656387665198,0.48598130841121495
677731,Francisco Hernandez,396,281,68,497,159,66,893,440,134,0.49272116461366183,0.30454545454545456,0.15005599104143338,0.44344904815229563,0.7095959595959596,0.24199288256227758,0.5565509518477044,0.3199195171026157,0.41509433962264153
677985,Jonathan Diaz,76,39,8,94,24,7,170,63,15,0.37058823529411766,0.23809523809523808,0.08823529411764706,0.4470588235294118,0.5131578947368421,0.20512820512820512,0.5529411764705883,0.2553191489361702,0.2916666666666667
678006,Nick Decker,415,278,113,554,197,86,969,475,199,0.49019607843137253,0.4189473684210526,0.20536635706914344,0.4282765737874097,0.6698795180722892,0.4064748201438849,0.5717234262125903,0.3555956678700361,0.4365482233502538
678010,Nick Schnell,644,485,185,905,333,146,1549,818,331,0.5280826339573919,0.40464547677261614,0.21368624919302776,0.4157520981278244,0.7531055900621118,0.38144329896907214,0.5842479018721756,0.3679558011049724,0.43843843843843844
678099,Gavin Logan,384,220,55,491,123,39,875,343,94,0.392,0.27405247813411077,0.10742857142857143,0.43885714285714283,0.5729166666666666,0.25,0.5611428571428572,0.2505091649694501,0.3170731707317073
678173,David McCabe,624,319,60,817,262,61,1441,581,121,0.4031922276197085,0.2082616179001721,0.08396946564885496,0.43303261623872313,0.5112179487179487,0.18808777429467086,0.5669673837612769,0.32068543451652387,0.23282442748091603
678218,Brandon Valenzuela,274,195,50,354,115,40,628,310,90,0.49363057324840764,0.2903225806451613,0.14331210191082802,0.43630573248407645,0.7116788321167883,0.2564102564102564,0.5636942675159236,0.3248587570621469,0.34782608695652173
678232,Jesus Valdez,442,338,67,625,245,96,1067,583,163,0.5463917525773195,0.27958833619210977,0.1527647610121837,0.41424554826616683,0.7647058823529411,0.19822485207100593,0.5857544517338332,0.392,0.39183673469387753
678247,Leandro Emiliani,198,119,50,279,107,46,477,226,96,0.47379454926624737,0.4247787610619469,0.20125786163522014,0.41509433962264153,0.601010101010101,0.42016806722689076,0.5849056603773585,0.3835125448028674,0.42990654205607476
678285,Fabian Pertuz,424,318,60,639,235,98,1063,553,158,0.5202257761053621,0.2857142857142857,0.14863593603010347,0.3988711194731891,0.75,0.18867924528301888,0.6011288805268109,0.3677621283255086,0.41702127659574467
678323,Allan Cerda,30,20,6,93,25,11,123,45,17,0.36585365853658536,0.37777777777777777,0.13821138211382114,0.24390243902439024,0.6666666666666666,0.3,0.7560975609756098,0.26881720430107525,0.44
678362,Gilberto Jimenez,186,142,36,257,148,63,443,290,99,0.654627539503386,0.3413793103448276,0.2234762979683973,0.4198645598194131,0.7634408602150538,0.2535211267605634,0.5801354401805869,0.5758754863813229,0.42567567567567566
678405,Hansen Lopez,6,5,1,10,3,3,16,8,4,0.5,0.5,0.25,0.375,0.8333333333333334,0.2,0.625,0.3,1.0
678428,Joshwan Wright,302,209,29,245,65,18,547,274,47,0.5009140767824497,0.17153284671532848,0.08592321755027423,0.5521023765996343,0.6920529801324503,0.13875598086124402,0.44789762340036565,0.2653061224489796,0.27692307692307694
678479,Ivan Murzi,5,1,0,10,5,4,15,6,4,0.4,0.6666666666666666,0.26666666666666666,0.3333333333333333,0.2,0.0,0.6666666666666666,0.5,0.8
678534,Rixon Wingrove,809,564,213,812,273,122,1621,837,335,0.5163479333744602,0.4002389486260454,0.2066625539790253,0.49907464528069095,0.6971569839307787,0.3776595744680851,0.5009253547193091,0.33620689655172414,0.4468864468864469
678577,Junior Perez,1095,676,189,899,214,96,1994,890,285,0.4463390170511535,0.3202247191011236,0.14292878635907724,0.549147442326981,0.617351598173516,0.27958579881656803,0.45085255767301907,0.23804226918798665,0.4485981308411215
678584,Jose Acosta,260,196,56,378,167,62,638,363,118,0.5689655172413793,0.325068870523416,0.18495297805642633,0.40752351097178685,0.7538461538461538,0.2857142857142857,0.5924764890282131,0.4417989417989418,0.3712574850299401
678594,Randy Florentino,52,37,11,33,10,5,85,47,16,0.5529411764705883,0.3404255319148936,0.18823529411764706,0.611764705882353,0.7115384615384616,0.2972972972972973,0.38823529411764707,0.30303030303030304,0.5
678648,Herard Gonzalez,737,444,113,688,170,43,1425,614,156,0.43087719298245614,0.254071661237785,0.10947368421052632,0.5171929824561403,0.6024423337856174,0.2545045045045045,0.48280701754385963,0.24709302325581395,0.2529411764705882
678652,Jesus Chirinos,135,79,29,164,60,24,299,139,53,0.46488294314381273,0.381294964028777,0.17725752508361203,0.451505016722408,0.5851851851851851,0.3670886075949367,0.5484949832775919,0.36585365853658536,0.4
678663,Ramses Malave,78,52,12,105,43,28,183,95,40,0.5191256830601093,0.42105263157894735,0.2185792349726776,0.4262295081967213,0.6666666666666666,0.23076923076923078,0.5737704918032787,0.4095238095238095,0.6511627906976745
678681,Luis Toribio,803,512,151,826,201,86,1629,713,237,0.4376918354818907,0.332398316970547,0.14548802946593,0.49294045426642114,0.6376089663760897,0.294921875,0.5070595457335789,0.24334140435835352,0.42786069651741293
678742,Rainer Nunez,249,183,32,330,122,48,579,305,80,0.5267702936096719,0.26229508196721313,0.1381692573402418,0.43005181347150256,0.7349397590361446,0.17486338797814208,0.5699481865284974,0.3696969696969697,0.39344262295081966
678746,Diego Hernandez,31,22,5,28,11,5,59,33,10,0.559322033898305,0.30303030303030304,0.1694915254237288,0.5254237288135594,0.7096774193548387,0.22727272727272727,0.4745762711864407,0.39285714285714285,0.45454545454545453
678768,Victor Planchart,244,169,33,356,113,33,600,282,66,0.47,0.23404255319148937,0.11,0.4066666666666667,0.6926229508196722,0.1952662721893491,0.5933333333333334,0.31741573033707865,0.2920353982300885
678781,Angel Basabe,35,26,7,52,18,8,87,44,15,0.5057471264367817,0.3409090909090909,0.1724137931034483,0.40229885057471265,0.7428571428571429,0.2692307692307692,0.5977011494252874,0.34615384615384615,0.4444444444444444
678803,Anthony Garcia,445,265,94,447,146,67,892,411,161,0.460762331838565,0.39172749391727496,0.1804932735426009,0.49887892376681614,0.5955056179775281,0.35471698113207545,0.5011210762331838,0.32662192393736017,0.4589041095890411
678823,Enrique Valdez,158,111,45,106,43,25,264,154,70,0.5833333333333334,0.45454545454545453,0.26515151515151514,0.5984848484848485,0.7025316455696202,0.40540540540540543,0.4015151515151515,0.4056603773584906,0.5813953488372093
678825,Eduardo Salazar,90,58,12,132,46,19,222,104,31,0.46846846846846846,0.2980769230769231,0.13963963963963963,0.40540540540540543,0.6444444444444445,0.20689655172413793,0.5945945945945946,0.3484848484848485,0.41304347826086957
678832,Yunior Garcia,220,182,49,205,78,45,425,260,94,0.611764705882353,0.36153846153846153,0.2211764705882353,0.5176470588235295,0.8272727272727273,0.2692307692307692,0.4823529411764706,0.3804878048780488,0.5769230769230769
678841,Brandol Mezquita,192,113,38,363,152,63,555,265,101,0.4774774774774775,0.38113207547169814,0.18198198198198198,0.34594594594594597,0.5885416666666666,0.336283185840708,0.654054054054054,0.418732782369146,0.4144736842105263
678844,Eliezel Stevens,147,102,47,224,106,43,371,208,90,0.5606469002695418,0.4326923076923077,0.24258760107816713,0.39622641509433965,0.6938775510204082,0.46078431372549017,0.6037735849056604,0.4732142857142857,0.4056603773584906
678849,Rolando Espinosa,298,196,64,466,152,83,764,348,147,0.45549738219895286,0.4224137931034483,0.19240837696335078,0.3900523560209424,0.6577181208053692,0.32653061224489793,0.6099476439790575,0.3261802575107296,0.5460526315789473
678854,Viandel Pena,707,364,83,915,329,83,1622,693,166,0.4272503082614057,0.23953823953823955,0.10234278668310727,0.4358816276202219,0.5148514851485149,0.22802197802197802,0.564118372379778,0.35956284153005463,0.25227963525835867
678866,Richard Paz,2,1,0,3,1,0,5,2,0,0.4,0.0,0.0,0.4,0.5,0.0,0.6,0.3333333333333333,0.0
678912,Jommer Hernandez,332,242,65,542,184,103,874,426,168,0.4874141876430206,0.39436619718309857,0.19221967963386727,0.37986270022883295,0.7289156626506024,0.26859504132231404,0.620137299771167,0.33948339483394835,0.5597826086956522
679243,Cristopher De Guzman,7,4,0,14,4,3,21,8,3,0.38095238095238093,0.375,0.14285714285714285,0.3333333333333333,0.5714285714285714,0.0,0.6666666666666666,0.2857142857142857,0.75
679295,Scott Ota,43,29,4,26,11,5,69,40,9,0.5797101449275363,0.225,0.13043478260869565,0.6231884057971014,0.6744186046511628,0.13793103448275862,0.37681159420289856,0.4230769230769231,0.45454545454545453
679311,Juan Crisp,25,15,4,13,4,2,38,19,6,0.5,0.3157894736842105,0.15789473684210525,0.6578947368421053,0.6,0.26666666666666666,0.34210526315789475,0.3076923076923077,0.5
679545,Joe Suozzi,210,135,31,233,74,21,443,209,52,0.4717832957110609,0.24880382775119617,0.11738148984198646,0.47404063205417607,0.6428571428571429,0.22962962962962963,0.5259593679458239,0.31759656652360513,0.28378378378378377
679628,Jacob Teter,445,243,61,463,147,45,908,390,106,0.42951541850220265,0.2717948717948718,0.11674008810572688,0.4900881057268722,0.5460674157303371,0.25102880658436216,0.5099118942731278,0.3174946004319654,0.30612244897959184
679718,Kyle Lovelace,12,10,5,8,2,1,20,12,6,0.6,0.5,0.3,0.6,0.8333333333333334,0.5,0.4,0.25,0.5
679741,Wilderd Patino,653,487,101,981,307,148,1634,794,249,0.48592411260709917,0.3136020151133501,0.15238678090575275,0.3996328029375765,0.7457886676875957,0.20739219712525667,0.6003671970624235,0.3129459734964322,0.4820846905537459
679751,Danny Bautista Jr.,943,613,74,669,186,48,1612,799,122,0.4956575682382134,0.15269086357947434,0.07568238213399504,0.5849875930521092,0.6500530222693531,0.12071778140293637,0.4150124069478908,0.27802690582959644,0.25806451612903225
679754,Alberto Rodriguez,534,382,70,680,202,78,1214,584,148,0.48105436573311366,0.2534246575342466,0.12191103789126853,0.43986820428336076,0.7153558052434457,0.18324607329842932,0.5601317957166392,0.29705882352941176,0.38613861386138615
679788,Jack Rogers,629,418,114,967,344,130,1596,762,244,0.4774436090225564,0.32020997375328086,0.15288220551378445,0.3941102756892231,0.6645468998410174,0.2727272727272727,0.6058897243107769,0.3557394002068252,0.37790697674418605
679881,J.P. Martinez,16,9,3,25,6,2,41,15,5,0.36585365853658536,0.3333333333333333,0.12195121951219512,0.3902439024390244,0.5625,0.3333333333333333,0.6097560975609756,0.24,0.3333333333333333
679972,Arturo De Freitas,219,162,55,229,74,29,448,236,84,0.5267857142857143,0.3559322033898305,0.1875,0.4888392857142857,0.7397260273972602,0.3395061728395062,0.5111607142857143,0.3231441048034934,0.3918918918918919
680273,Chris Meyers,349,223,55,264,68,28,613,291,83,0.47471451876019577,0.2852233676975945,0.13539967373572595,0.5693311582381729,0.6389684813753582,0.24663677130044842,0.43066884176182707,0.25757575757575757,0.4117647058823529
680396,Joe Stewart,1016,680,153,910,249,110,1926,929,263,0.48234683281412255,0.2831001076426265,0.13655244029075805,0.5275181723779855,0.6692913385826772,0.225,0.4724818276220145,0.27362637362637365,0.44176706827309237
680421,Ben Norman,42,22,0,50,11,5,92,33,5,0.358695652173913,0.15151515151515152,0.05434782608695652,0.45652173913043476,0.5238095238095238,0.0,0.5434782608695652,0.22,0.45454545454545453
680519,Mario Camilletti,110,63,9,148,20,4,258,83,13,0.32170542635658916,0.1566265060240964,0.050387596899224806,0.4263565891472868,0.5727272727272728,0.14285714285714285,0.5736434108527132,0.13513513513513514,0.2
680552,Travis Swaggerty,4,4,1,14,3,0,18,7,1,0.3888888888888889,0.14285714285714285,0.05555555555555555,0.2222222222222222,1.0,0.25,0.7777777777777778,0.21428571428571427,0.0
680631,Oneill Manzueta,119,82,30,253,96,46,372,178,76,0.478494623655914,0.42696629213483145,0.20430107526881722,0.31989247311827956,0.6890756302521008,0.36585365853658536,0.6801075268817204,0.3794466403162055,0.4791666666666667
680636,Ramon Mendoza,454,312,53,596,180,71,1050,492,124,0.4685714285714286,0.25203252032520324,0.1180952380952381,0.43238095238095237,0.6872246696035242,0.16987179487179488,0.5676190476190476,0.30201342281879195,0.39444444444444443
680642,Darlin Moquete,348,229,42,470,162,68,818,391,110,0.4779951100244499,0.2813299232736573,0.13447432762836187,0.4254278728606357,0.6580459770114943,0.18340611353711792,0.5745721271393643,0.3446808510638298,0.41975308641975306
680643,Juan Mora,56,32,5,57,24,13,113,56,18,0.49557522123893805,0.32142857142857145,0.1592920353982301,0.49557522123893805,0.5714285714285714,0.15625,0.504424778761062,0.42105263157894735,0.5416666666666666
680664,Eduardo Valencia,86,60,14,43,12,5,129,72,19,0.5581395348837209,0.2638888888888889,0.14728682170542637,0.6666666666666666,0.6976744186046512,0.23333333333333334,0.3333333333333333,0.27906976744186046,0.4166666666666667
680695,Brennen Davis,28,21,4,58,32,16,86,53,20,0.6162790697674418,0.37735849056603776,0.23255813953488372,0.32558139534883723,0.75,0.19047619047619047,0.6744186046511628,0.5517241379310345,0.5
680698,Charles Mack,72,42,14,58,15,6,130,57,20,0.43846153846153846,0.3508771929824561,0.15384615384615385,0.5538461538461539,0.5833333333333334,0.3333333333333333,0.4461538461538462,0.25862068965517243,0.4
680703,Cory Acton,153,74,26,245,84,39,398,158,65,0.3969849246231156,0.41139240506329117,0.16331658291457288,0.3844221105527638,0.48366013071895425,0.35135135135135137,0.6155778894472361,0.34285714285714286,0.4642857142857143
680756,Matheu Nelson,481,333,78,918,344,141,1399,677,219,0.4839170836311651,0.32348596750369274,0.15654038598999284,0.3438170121515368,0.6923076923076923,0.23423423423423423,0.6561829878484632,0.3747276688453159,0.40988372093023256
680771,Mateo Gil,355,243,50,555,209,68,910,452,118,0.4967032967032967,0.2610619469026549,0.12967032967032968,0.3901098901098901,0.6845070422535211,0.205761316872428,0.6098901098901099,0.37657657657657656,0.3253588516746411
680815,Damon Dues,416,245,40,593,164,46,1009,409,86,0.4053518334985134,0.21026894865525672,0.08523290386521308,0.4122893954410307,0.5889423076923077,0.16326530612244897,0.5877106045589693,0.2765598650927487,0.2804878048780488
680852,Wilfredo Flores,334,248,57,308,122,31,642,370,88,0.5763239875389408,0.23783783783783785,0.13707165109034267,0.5202492211838006,0.7425149700598802,0.22983870967741934,0.4797507788161994,0.3961038961038961,0.2540983606557377
680874,Tim Borden II,674,436,148,844,295,126,1518,731,274,0.48155467720685113,0.3748290013679891,0.18050065876152832,0.4440052700922266,0.6468842729970327,0.3394495412844037,0.5559947299077734,0.3495260663507109,0.4271186440677966
680906,Josiah Sightler,229,151,57,332,138,54,561,289,111,0.5151515151515151,0.38408304498269896,0.19786096256684493,0.40819964349376114,0.6593886462882096,0.37748344370860926,0.5918003565062389,0.41566265060240964,0.391304347826087
680910,Robby Martin Jr.,264,193,61,231,69,29,495,262,90,0.5292929292929293,0.3435114503816794,0.18181818181818182,0.5333333333333333,0.7310606060606061,0.3160621761658031,0.4666666666666667,0.2987012987012987,0.42028985507246375
680915,David Hollie,152,102,38,173,54,30,325,156,68,0.48,0.4358974358974359,0.20923076923076922,0.4676923076923077,0.6710526315789473,0.37254901960784315,0.5323076923076923,0.31213872832369943,0.5555555555555556
680918,Brady Allen,865,577,129,1123,325,131,1988,902,260,0.4537223340040241,0.28824833702882485,0.13078470824949698,0.4351106639839034,0.6670520231213873,0.22357019064124783,0.5648893360160966,0.2894033837934105,0.40307692307692305
680963,Cody Wilson,91,53,17,157,59,26,248,112,43,0.45161290322580644,0.38392857142857145,0.17338709677419356,0.36693548387096775,0.5824175824175825,0.32075471698113206,0.6330645161290323,0.37579617834394907,0.4406779661016949
680994,Nick Biddison,194,115,33,199,61,32,393,176,65,0.44783715012722647,0.3693181818181818,0.16539440203562342,0.49363867684478374,0.5927835051546392,0.28695652173913044,0.5063613231552163,0.3065326633165829,0.5245901639344263
680998,Branden Boissiere,237,156,32,279,116,33,516,272,65,0.5271317829457365,0.23897058823529413,0.12596899224806202,0.45930232558139533,0.6582278481012658,0.20512820512820512,0.5406976744186046,0.4157706093189964,0.28448275862068967
681036,Anthony Vilar,201,118,32,239,74,24,440,192,56,0.43636363636363634,0.2916666666666667,0.12727272727272726,0.45681818181818185,0.5870646766169154,0.2711864406779661,0.5431818181818182,0.30962343096234307,0.32432432432432434
681047,Christian Franklin,450,247,43,707,199,74,1157,446,117,0.38547968885047534,0.2623318385650224,0.10112359550561797,0.3889369057908384,0.5488888888888889,0.17408906882591094,0.6110630942091616,0.2814710042432815,0.37185929648241206
681068,Jayce Easley,418,236,52,852,290,73,1270,526,125,0.4141732283464567,0.2376425855513308,0.0984251968503937,0.3291338582677165,0.5645933014354066,0.22033898305084745,0.6708661417322834,0.3403755868544601,0.2517241379310345
681080,Caleb Ricketts,331,222,51,307,123,27,638,345,78,0.5407523510971787,0.22608695652173913,0.12225705329153605,0.5188087774294671,0.6706948640483383,0.22972972972972974,0.48119122257053293,0.4006514657980456,0.21951219512195122
681098,Bill Knight,86,61,15,97,31,17,183,92,32,0.5027322404371585,0.34782608695652173,0.17486338797814208,0.46994535519125685,0.7093023255813954,0.2459016393442623,0.5300546448087432,0.31958762886597936,0.5483870967741935
681114,Michael Trautwein,236,151,54,345,116,45,581,267,99,0.459552495697074,0.3707865168539326,0.1703958691910499,0.40619621342512907,0.6398305084745762,0.3576158940397351,0.5938037865748709,0.336231884057971,0.3879310344827586
681132,Max Ferguson,625,331,87,855,265,94,1480,596,181,0.4027027027027027,0.3036912751677852,0.1222972972972973,0.4222972972972973,0.5296,0.2628398791540785,0.5777027027027027,0.30994152046783624,0.35471698113207545
681142,Justice Thompson,568,391,93,1028,336,161,1596,727,254,0.45551378446115287,0.3493810178817056,0.15914786967418545,0.3558897243107769,0.6883802816901409,0.23785166240409208,0.6441102756892231,0.32684824902723736,0.4791666666666667
681184,Kevin Graham,483,328,89,548,174,74,1031,502,163,0.486905916585839,0.3247011952191235,0.15809893307468478,0.4684772065955383,0.6790890269151139,0.27134146341463417,0.5315227934044617,0.3175182481751825,0.42528735632183906
681198,T.J. Rumfield,28,17,2,26,12,1,54,29,3,0.5370370370370371,0.10344827586206896,0.05555555555555555,0.5185185185185185,0.6071428571428571,0.11764705882352941,0.48148148148148145,0.46153846153846156,0.08333333333333333
681201,Tanner O'Tremba,38,29,9,91,38,25,129,67,34,0.5193798449612403,0.5074626865671642,0.26356589147286824,0.29457364341085274,0.7631578947368421,0.3103448275862069,0.7054263565891473,0.4175824175824176,0.6578947368421053
681234,Charlie Welch,221,140,41,342,83,40,563,223,81,0.3960923623445826,0.3632286995515695,0.1438721136767318,0.3925399644760213,0.6334841628959276,0.29285714285714287,0.6074600355239786,0.24269005847953215,0.4819277108433735
681326,Cole Moore,91,50,13,109,33,8,200,83,21,0.415,0.25301204819277107,0.105,0.455,0.5494505494505495,0.26,0.545,0.30275229357798167,0.24242424242424243
681333,Dru Baker,500,294,63,932,346,106,1432,640,169,0.44692737430167595,0.2640625,0.1180167597765363,0.34916201117318435,0.588,0.21428571428571427,0.6508379888268156,0.37124463519313305,0.3063583815028902
681334,Justin Williams,421,284,109,531,206,80,952,490,189,0.5147058823529411,0.38571428571428573,0.19852941176470587,0.4422268907563025,0.6745843230403801,0.38380281690140844,0.5577731092436975,0.3879472693032015,0.3883495145631068
681339,Brendan Tinsman,61,27,7,60,18,9,121,45,16,0.371900826446281,0.35555555555555557,0.1322314049586777,0.5041322314049587,0.4426229508196721,0.25925925925925924,0.49586776859504134,0.3,0.5
681348,Hayden Jones,110,92,34,153,76,33,263,168,67,0.6387832699619772,0.39880952380952384,0.25475285171102663,0.41825095057034223,0.8363636363636363,0.3695652173913043,0.5817490494296578,0.49673202614379086,0.4342105263157895
681355,Andrew Cossetti,428,262,79,542,141,49,970,403,128,0.4154639175257732,0.3176178660049628,0.13195876288659794,0.44123711340206184,0.6121495327102804,0.3015267175572519,0.5587628865979382,0.26014760147601473,0.3475177304964539
681370,Hudson Haskin,28,20,6,51,8,2,79,28,8,0.35443037974683544,0.2857142857142857,0.10126582278481013,0.35443037974683544,0.7142857142857143,0.3,0.6455696202531646,0.1568627450980392,0.25
681371,Dominic Keegan,357,206,47,466,126,39,823,332,86,0.40340218712029163,0.25903614457831325,0.10449574726609964,0.43377885783718106,0.5770308123249299,0.22815533980582525,0.5662211421628189,0.2703862660944206,0.30952380952380953
681377,Josh Hood,121,75,16,139,35,19,260,110,35,0.4230769230769231,0.3181818181818182,0.1346153846153846,0.4653846153846154,0.6198347107438017,0.21333333333333335,0.5346153846153846,0.2517985611510791,0.5428571428571428
681400,Danny Serretti,483,282,39,420,99,24,903,381,63,0.4219269102990033,0.16535433070866143,0.06976744186046512,0.5348837209302325,0.5838509316770186,0.13829787234042554,0.46511627906976744,0.2357142857142857,0.24242424242424243
681433,Noah Cardenas,684,416,65,869,177,54,1553,593,119,0.381841596909208,0.20067453625632378,0.07662588538312942,0.44043786220218933,0.6081871345029239,0.15625,0.5595621377978107,0.20368239355581128,0.3050847457627119
681439,Zach Morgan,154,114,18,176,53,23,330,167,41,0.5060606060606061,0.24550898203592814,0.12424242424242424,0.4666666666666667,0.7402597402597403,0.15789473684210525,0.5333333333333333,0.30113636363636365,0.4339622641509434
681460,Brooks Baldwin,187,143,32,210,79,29,397,222,61,0.5591939546599496,0.2747747747747748,0.15365239294710328,0.47103274559193953,0.7647058823529411,0.22377622377622378,0.5289672544080605,0.3761904761904762,0.3670886075949367
681466,James Parker,500,347,134,749,237,134,1249,584,268,0.4675740592473979,0.4589041095890411,0.2145716573258607,0.400320256204964,0.694,0.3861671469740634,0.5996797437950361,0.3164218958611482,0.5654008438818565
681487,Robert Emery,29,19,4,53,15,8,82,34,12,0.4146341463414634,0.35294117647058826,0.14634146341463414,0.35365853658536583,0.6551724137931034,0.21052631578947367,0.6463414634146342,0.2830188679245283,0.5333333333333333
681488,Logan Cerny,640,352,118,810,292,120,1450,644,238,0.44413793103448274,0.3695652173913043,0.16413793103448276,0.4413793103448276,0.55,0.3352272727272727,0.5586206896551724,0.36049382716049383,0.410958904109589
681495,Cade Fergus,89,48,24,114,41,21,203,89,45,0.43842364532019706,0.5056179775280899,0.22167487684729065,0.43842364532019706,0.5393258426966292,0.5,0.5615763546798029,0.35964912280701755,0.5121951219512195
681521,Eric Kennedy,157,95,26,183,55,17,340,150,43,0.4411764705882353,0.2866666666666667,0.1264705882352941,0.46176470588235297,0.6050955414012739,0.2736842105263158,0.538235294117647,0.3005464480874317,0.3090909090909091
681580,Michael Turconi,531,345,84,752,208,74,1283,553,158,0.4310210444271239,0.2857142857142857,0.12314886983632112,0.4138737334372564,0.6497175141242938,0.24347826086956523,0.5861262665627436,0.2765957446808511,0.3557692307692308
681623,Ronaiker Palma,384,258,21,398,75,30,782,333,51,0.4258312020460358,0.15315315315315314,0.06521739130434782,0.49104859335038364,0.671875,0.08139534883720931,0.5089514066496164,0.1884422110552764,0.4
681679,Stanley Consuegra,520,372,101,857,350,135,1377,722,236,0.524328249818446,0.3268698060941828,0.17138707334785766,0.3776325344952796,0.7153846153846154,0.271505376344086,0.6223674655047204,0.40840140023337224,0.38571428571428573
681812,Edison Mora,214,161,52,264,88,26,478,249,78,0.5209205020920502,0.3132530120481928,0.16317991631799164,0.4476987447698745,0.7523364485981309,0.32298136645962733,0.5523012552301255,0.3333333333333333,0.29545454545454547
681831,Willie Joe Garry Jr.,328,189,53,284,63,29,612,252,82,0.4117647058823529,0.3253968253968254,0.13398692810457516,0.5359477124183006,0.5762195121951219,0.2804232804232804,0.46405228758169936,0.22183098591549297,0.4603174603174603
681852,Sean Roby,162,126,38,169,47,26,331,173,64,0.5226586102719033,0.3699421965317919,0.1933534743202417,0.48942598187311176,0.7777777777777778,0.30158730158730157,0.5105740181268882,0.2781065088757396,0.5531914893617021
681866,Keegan Fish,155,105,37,215,58,31,370,163,68,0.44054054054054054,0.4171779141104294,0.1837837837837838,0.4189189189189189,0.6774193548387096,0.3523809523809524,0.581081081081081,0.26976744186046514,0.5344827586206896
681868,Ezequiel Pagan,738,470,84,875,314,68,1613,784,152,0.486050836949783,0.19387755102040816,0.09423434593924365,0.4575325480471172,0.6368563685636857,0.17872340425531916,0.5424674519528828,0.3588571428571429,0.21656050955414013
681933,Michael Wielansky,45,31,6,59,26,8,104,57,14,0.5480769230769231,0.24561403508771928,0.1346153846153846,0.4326923076923077,0.6888888888888889,0.1935483870967742,0.5673076923076923,0.4406779661016949,0.3076923076923077
681941,Jaylen Palmer,411,218,73,559,162,79,970,380,152,0.3917525773195876,0.4,0.15670103092783505,0.42371134020618556,0.5304136253041363,0.3348623853211009,0.5762886597938144,0.2898032200357782,0.4876543209876543
681974,Onix Vega,134,83,12,124,36,12,258,119,24,0.46124031007751937,0.20168067226890757,0.09302325581395349,0.5193798449612403,0.6194029850746269,0.14457831325301204,0.4806201550387597,0.2903225806451613,0.3333333333333333
682011,Tyler Miller,562,455,128,772,338,128,1334,793,256,0.5944527736131934,0.3228247162673392,0.191904047976012,0.42128935532233885,0.8096085409252669,0.2813186813186813,0.5787106446776612,0.4378238341968912,0.378698224852071
682039,Jacen Roberson,262,158,52,358,91,38,620,249,90,0.40161290322580645,0.3614457831325301,0.14516129032258066,0.42258064516129035,0.6030534351145038,0.3291139240506329,0.5774193548387097,0.2541899441340782,0.4175824175824176
682090,Gionti Turner,69,42,10,116,46,13,185,88,23,0.4756756756756757,0.26136363636363635,0.12432432432432433,0.372972972972973,0.6086956521739131,0.23809523809523808,0.6270270270270271,0.39655172413793105,0.2826086956521739
682187,Nick Ward,746,435,84,845,202,36,1591,637,120,0.40037712130735387,0.18838304552590268,0.0754242614707731,0.4688874921433061,0.5831099195710456,0.19310344827586207,0.531112507856694,0.23905325443786982,0.1782178217821782
682218,Tyler Reichenborn,254,163,31,348,93,38,602,256,69,0.42524916943521596,0.26953125,0.11461794019933555,0.4219269102990033,0.6417322834645669,0.1901840490797546,0.5780730897009967,0.2672413793103448,0.40860215053763443
682266,Brett Auerbach,338,218,64,422,118,57,760,336,121,0.4421052631578947,0.3601190476190476,0.15921052631578947,0.44473684210526315,0.6449704142011834,0.29357798165137616,0.5552631578947368,0.2796208530805687,0.4830508474576271
682276,Jose Cordova,37,31,6,42,12,8,79,43,14,0.5443037974683544,0.32558139534883723,0.17721518987341772,0.46835443037974683,0.8378378378378378,0.1935483870967742,0.5316455696202531,0.2857142857142857,0.6666666666666666
682424,Nate Soria,64,40,12,124,45,18,188,85,30,0.4521276595744681,0.35294117647058826,0.1595744680851064,0.3404255319148936,0.625,0.3,0.6595744680851063,0.3629032258064516,0.4
682452,Cesar Berbesi,356,202,62,412,120,56,768,322,118,0.4192708333333333,0.36645962732919257,0.15364583333333334,0.4635416666666667,0.5674157303370787,0.3069306930693069,0.5364583333333334,0.2912621359223301,0.4666666666666667
682618,Misael Urbina,754,443,83,874,251,95,1628,694,178,0.4262899262899263,0.2564841498559078,0.10933660933660934,0.4631449631449631,0.5875331564986738,0.1873589164785553,0.5368550368550369,0.28718535469107553,0.3784860557768924
682625,Antonio Gomez,569,434,135,726,287,138,1295,721,273,0.5567567567567567,0.3786407766990291,0.21081081081081082,0.43938223938223936,0.7627416520210897,0.31105990783410137,0.5606177606177606,0.3953168044077135,0.4808362369337979
682628,Junior Sanquintin,339,262,89,429,209,102,768,471,191,0.61328125,0.40552016985138006,0.24869791666666666,0.44140625,0.7728613569321534,0.33969465648854963,0.55859375,0.48717948717948717,0.4880382775119617
682631,Eduarqui Fernandez,249,156,48,426,160,80,675,316,128,0.46814814814814815,0.4050632911392405,0.18962962962962962,0.3688888888888889,0.6265060240963856,0.3076923076923077,0.6311111111111111,0.3755868544600939,0.5
682633,Eduardo Garcia,466,304,90,785,316,127,1251,620,217,0.495603517186251,0.35,0.17346123101518784,0.37250199840127896,0.6523605150214592,0.29605263157894735,0.627498001598721,0.40254777070063696,0.40189873417721517
682634,Kevin Alcantara,707,481,108,773,305,135,1480,786,243,0.5310810810810811,0.30916030534351147,0.16418918918918918,0.4777027027027027,0.6803394625176803,0.22453222453222454,0.5222972972972973,0.3945666235446313,0.4426229508196721
682637,Eduardo Lopez,494,285,81,705,256,76,1199,541,157,0.451209341117598,0.2902033271719039,0.13094245204336946,0.41201000834028356,0.5769230769230769,0.28421052631578947,0.5879899916597164,0.36312056737588655,0.296875
682643,Alexander Ramirez,918,659,194,782,272,152,1700,931,346,0.5476470588235294,0.3716433941997852,0.20352941176470588,0.54,0.7178649237472767,0.2943854324734446,0.46,0.34782608695652173,0.5588235294117647
682648,Juan Guerrero,850,625,75,932,305,112,1782,930,187,0.5218855218855218,0.2010752688172043,0.10493827160493827,0.4769921436588103,0.7352941176470589,0.12,0.5230078563411896,0.3272532188841202,0.36721311475409835
682650,Malcom Nunez,30,15,4,60,20,6,90,35,10,0.3888888888888889,0.2857142857142857,0.1111111111111111,0.3333333333333333,0.5,0.26666666666666666,0.6666666666666666,0.3333333333333333,0.3
682663,Agustin Ramirez,181,124,22,214,77,16,395,201,38,0.5088607594936709,0.1890547263681592,0.09620253164556962,0.4582278481012658,0.6850828729281768,0.1774193548387097,0.5417721518987342,0.3598130841121495,0.2077922077922078
682674,Victor Bericoto,414,278,53,716,262,105,1130,540,158,0.4778761061946903,0.29259259259259257,0.13982300884955753,0.3663716814159292,0.6714975845410628,0.1906474820143885,0.6336283185840708,0.3659217877094972,0.40076335877862596
682679,Dayan Frias,598,393,86,904,310,91,1502,703,177,0.46804260985352863,0.25177809388335703,0.11784287616511319,0.3981358189081225,0.657190635451505,0.21882951653944022,0.6018641810918774,0.34292035398230086,0.29354838709677417
682692,Miguel Palma,406,301,93,528,180,38,934,481,131,0.5149892933618844,0.27234927234927236,0.14025695931477516,0.4346895074946467,0.7413793103448276,0.3089700996677741,0.5653104925053534,0.3409090909090909,0.2111111111111111
682707,Jeremy De La Rosa,740,472,185,785,289,115,1525,761,300,0.49901639344262294,0.39421813403416556,0.19672131147540983,0.4852459016393443,0.6378378378378379,0.3919491525423729,0.5147540983606558,0.3681528662420382,0.39792387543252594
682714,Yoander Rivero,98,69,22,120,36,10,218,105,32,0.481651376146789,0.3047619047619048,0.14678899082568808,0.44954128440366975,0.7040816326530612,0.3188405797101449,0.5504587155963303,0.3,0.2777777777777778
682722,Isaac De Leon,649,404,101,919,244,119,1568,648,220,0.413265306122449,0.3395061728395062,0.14030612244897958,0.4139030612244898,0.6224961479198767,0.25,0.5860969387755102,0.26550598476605003,0.48770491803278687
682725,Cristhian Rodriguez,113,75,21,136,51,29,249,126,50,0.5060240963855421,0.3968253968253968,0.20080321285140562,0.4538152610441767,0.6637168141592921,0.28,0.5461847389558233,0.375,0.5686274509803921
682728,Luis Chevalier,55,38,10,69,18,7,124,56,17,0.45161290322580644,0.30357142857142855,0.13709677419354838,0.4435483870967742,0.6909090909090909,0.2631578947368421,0.5564516129032258,0.2608695652173913,0.3888888888888889
682729,Jonatan Clase,211,143,21,239,41,23,450,184,44,0.4088888888888889,0.2391304347826087,0.09777777777777778,0.4688888888888889,0.6777251184834123,0.14685314685314685,0.5311111111111111,0.17154811715481172,0.5609756097560976
682774,Andrick Nava,470,351,98,511,152,35,981,503,133,0.5127420998980632,0.2644135188866799,0.13557594291539246,0.47910295616717635,0.7468085106382979,0.2792022792022792,0.5208970438328236,0.2974559686888454,0.23026315789473684
682775,Kervin Pichardo,452,273,62,570,141,61,1022,414,123,0.4050880626223092,0.2971014492753623,0.12035225048923678,0.44227005870841485,0.6039823008849557,0.2271062271062271,0.5577299412915852,0.24736842105263157,0.4326241134751773
682793,Bryan Gonzalez,568,414,133,1025,417,238,1593,831,371,0.5216572504708098,0.4464500601684717,0.23289391086001254,0.35655994978028877,0.7288732394366197,0.321256038647343,0.6434400502197113,0.4068292682926829,0.5707434052757794
682796,Eddinson Paulino,857,520,135,1057,341,128,1914,861,263,0.4498432601880878,0.305458768873403,0.13740856844305122,0.4477533960292581,0.6067677946324388,0.25961538461538464,0.5522466039707419,0.3226111636707663,0.375366568914956
682799,Elio Prado,262,176,37,277,88,29,539,264,66,0.4897959183673469,0.25,0.12244897959183673,0.48608534322820035,0.6717557251908397,0.21022727272727273,0.5139146567717996,0.3176895306859206,0.32954545454545453
682801,Noelberth Romero,42,30,7,37,14,6,79,44,13,0.5569620253164557,0.29545454545454547,0.16455696202531644,0.5316455696202531,0.7142857142857143,0.23333333333333334,0.46835443037974683,0.3783783783783784,0.42857142857142855
682818,Yohendrick Pinango,818,530,119,822,319,64,1640,849,183,0.5176829268292683,0.21554770318021202,0.11158536585365854,0.49878048780487805,0.6479217603911981,0.22452830188679246,0.501219512195122,0.3880778588807786,0.2006269592476489
682830,Ilvin Fernandez,18,10,2,7,3,2,25,13,4,0.52,0.3076923076923077,0.16,0.72,0.5555555555555556,0.2,0.28,0.42857142857142855,0.6666666666666666
682844,Lazaro Benitez,163,126,24,127,39,21,290,165,45,0.5689655172413793,0.2727272727272727,0.15517241379310345,0.5620689655172414,0.7730061349693251,0.19047619047619047,0.4379310344827586,0.30708661417322836,0.5384615384615384
682864,Aiverson Rodriguez,87,62,13,132,36,18,219,98,31,0.4474885844748858,0.3163265306122449,0.1415525114155251,0.3972602739726027,0.7126436781609196,0.20967741935483872,0.6027397260273972,0.2727272727272727,0.5
682877,Juan Brito,246,162,29,345,89,16,591,251,45,0.42470389170896783,0.17928286852589642,0.07614213197969544,0.41624365482233505,0.6585365853658537,0.17901234567901234,0.583756345177665,0.2579710144927536,0.1797752808988764
682900,Brainer Bonaci,413,269,58,595,211,81,1008,480,139,0.47619047619047616,0.28958333333333336,0.1378968253968254,0.4097222222222222,0.6513317191283293,0.21561338289962825,0.5902777777777778,0.3546218487394958,0.38388625592417064
682942,Alex De Jesus,536,337,97,808,273,97,1344,610,194,0.4538690476190476,0.3180327868852459,0.14434523809523808,0.39880952380952384,0.628731343283582,0.2878338278931751,0.6011904761904762,0.3378712871287129,0.3553113553113553
682983,Jud Fabian,397,256,75,557,159,72,954,415,147,0.4350104821802935,0.3542168674698795,0.1540880503144654,0.4161425576519916,0.6448362720403022,0.29296875,0.5838574423480084,0.28545780969479356,0.4528301886792453
682987,Spencer Jones,886,526,145,933,328,107,1819,854,252,0.46948873007146785,0.29508196721311475,0.13853765805387575,0.48708081363386474,0.5936794582392777,0.27566539923954375,0.5129191863661352,0.3515541264737406,0.32621951219512196
682988,Tyler Locklear,407,284,66,614,199,74,1021,483,140,0.4730656219392752,0.2898550724637681,0.13712047012732614,0.39862879529872675,0.6977886977886978,0.2323943661971831,0.6013712047012733,0.3241042345276873,0.37185929648241206
682997,Tyler Callihan,709,525,130,891,350,105,1600,875,235,0.546875,0.26857142857142857,0.146875,0.443125,0.7404795486600846,0.24761904761904763,0.556875,0.39281705948372614,0.3
683001,Ethan Hearn,506,334,116,483,187,65,989,521,181,0.5267947421638018,0.3474088291746641,0.18301314459049545,0.5116279069767442,0.6600790513833992,0.3473053892215569,0.4883720930232558,0.38716356107660455,0.34759358288770054
683006,Chris Newell,391,227,73,341,94,49,732,321,122,0.4385245901639344,0.38006230529595014,0.16666666666666666,0.5341530054644809,0.5805626598465473,0.32158590308370044,0.46584699453551914,0.2756598240469208,0.5212765957446809
683031,Jean Ramirez,173,105,27,162,57,12,335,162,39,0.4835820895522388,0.24074074074074073,0.11641791044776119,0.5164179104477612,0.6069364161849711,0.2571428571428571,0.4835820895522388,0.35185185185185186,0.21052631578947367
683058,Isaac Bellony,322,230,106,313,110,57,635,340,163,0.5354330708661418,0.47941176470588237,0.2566929133858268,0.5070866141732283,0.7142857142857143,0.4608695652173913,0.49291338582677163,0.3514376996805112,0.5181818181818182
683061,Alexander Vargas,783,572,152,762,321,114,1545,893,266,0.5779935275080906,0.2978723404255319,0.17216828478964402,0.5067961165048543,0.7305236270753512,0.26573426573426573,0.49320388349514566,0.421259842519685,0.35514018691588783
683103,Cade Doughty,654,485,126,943,368,168,1597,853,294,0.5341264871634315,0.34466588511137164,0.18409517845961176,0.4095178459611772,0.7415902140672783,0.2597938144329897,0.5904821540388228,0.3902439024390244,0.45652173913043476
683104,Trey Faltine,281,190,69,490,165,84,771,355,153,0.4604409857328145,0.4309859154929577,0.19844357976653695,0.364461738002594,0.6761565836298933,0.3631578947368421,0.6355382619974059,0.336734693877551,0.509090909090909
683170,Kadon Morton,396,254,107,677,273,108,1073,527,215,0.4911463187325256,0.4079696394686907,0.20037278657968313,0.36905871388630007,0.6414141414141414,0.421259842519685,0.6309412861136999,0.4032496307237814,0.3956043956043956
683227,Cody Freeman,447,280,43,1031,410,108,1478,690,151,0.4668470906630582,0.21884057971014492,0.10216508795669824,0.30243572395128554,0.6263982102908278,0.15357142857142858,0.6975642760487145,0.3976721629485936,0.2634146341463415
683233,Douglas Hodo III,62,37,5,106,35,13,168,72,18,0.42857142857142855,0.25,0.10714285714285714,0.36904761904761907,0.5967741935483871,0.13513513513513514,0.6309523809523809,0.330188679245283,0.37142857142857144
683364,Carlos Dominguez,12,8,2,23,10,7,35,18,9,0.5142857142857142,0.5,0.2571428571428571,0.34285714285714286,0.6666666666666666,0.25,0.6571428571428571,0.43478260869565216,0.7
683408,Darryl Collins,169,116,21,115,30,9,284,146,30,0.5140845070422535,0.2054794520547945,0.1056338028169014,0.5950704225352113,0.6863905325443787,0.1810344827586207,0.40492957746478875,0.2608695652173913,0.3
683414,Freddy Guilamo,125,60,25,173,59,29,298,119,54,0.39932885906040266,0.453781512605042,0.18120805369127516,0.41946308724832215,0.48,0.4166666666666667,0.5805369127516778,0.34104046242774566,0.4915254237288136
683447,Gabriel Martinez,661,510,66,952,363,152,1613,873,218,0.5412275263484191,0.24971363115693013,0.1351518908865468,0.4097954122752635,0.7715582450832073,0.12941176470588237,0.5902045877247365,0.38130252100840334,0.418732782369146
683454,Brayan Buelvas,237,162,51,235,65,23,472,227,74,0.4809322033898305,0.32599118942731276,0.15677966101694915,0.5021186440677966,0.6835443037974683,0.3148148148148148,0.4978813559322034,0.2765957446808511,0.35384615384615387
683469,Warren Saunders,52,34,10,92,36,13,144,70,23,0.4861111111111111,0.32857142857142857,0.1597222222222222,0.3611111111111111,0.6538461538461539,0.29411764705882354,0.6388888888888888,0.391304347826087,0.3611111111111111
683481,Nerwilian Cedeno,476,343,105,538,199,74,1014,542,179,0.534516765285996,0.33025830258302585,0.1765285996055227,0.46942800788954636,0.7205882352941176,0.30612244897959184,0.5305719921104537,0.36988847583643125,0.37185929648241206
683490,J.J. D'Orazio,444,317,53,713,231,96,1157,548,149,0.4736387208297321,0.2718978102189781,0.12878133102852204,0.3837510803802939,0.713963963963964,0.167192429022082,0.6162489196197062,0.32398316970546986,0.4155844155844156
683493,William Lugo,651,445,115,1011,358,120,1662,803,235,0.4831528279181709,0.29265255292652553,0.14139590854392298,0.3916967509025271,0.6835637480798771,0.25842696629213485,0.6083032490974729,0.35410484668644904,0.33519553072625696
683494,Euribiel Angeles,759,544,70,532,190,53,1291,734,123,0.56855151045701,0.167574931880109,0.09527498063516654,0.5879163439194423,0.7167325428194994,0.12867647058823528,0.4120836560805577,0.35714285714285715,0.2789473684210526
683500,Maikol Escotto,428,299,88,777,329,119,1205,628,207,0.5211618257261411,0.32961783439490444,0.17178423236514523,0.35518672199170126,0.6985981308411215,0.29431438127090304,0.6448132780082988,0.42342342342342343,0.3617021276595745
683532,Christopher Familia,352,245,66,381,146,38,733,391,104,0.5334242837653479,0.2659846547314578,0.14188267394270124,0.48021828103683495,0.6960227272727273,0.2693877551020408,0.519781718963165,0.38320209973753283,0.2602739726027397
683534,Efrenyer Narvaez,14,11,3,48,22,10,62,33,13,0.532258064516129,0.3939393939393939,0.20967741935483872,0.22580645161290322,0.7857142857142857,0.2727272727272727,0.7741935483870968,0.4583333333333333,0.45454545454545453
683546,Albert Fabian,257,191,60,341,137,47,598,328,107,0.5484949832775919,0.32621951219512196,0.17892976588628762,0.4297658862876254,0.7431906614785992,0.31413612565445026,0.5702341137123745,0.40175953079178883,0.34306569343065696
683550,Marcos Cabrera,413,295,87,545,199,108,958,494,195,0.5156576200417536,0.39473684210526316,0.2035490605427975,0.4311064718162839,0.7142857142857143,0.29491525423728815,0.5688935281837161,0.3651376146788991,0.542713567839196
683610,Leandro Pineda,817,532,163,832,244,76,1649,776,239,0.47058823529411764,0.3079896907216495,0.14493632504548212,0.4954517889630079,0.6511627906976745,0.30639097744360905,0.5045482110369921,0.2932692307692308,0.3114754098360656
683649,Angeudis Santos,56,33,10,78,15,7,134,48,17,0.3582089552238806,0.3541666666666667,0.12686567164179105,0.417910447761194,0.5892857142857143,0.30303030303030304,0.582089552238806,0.19230769230769232,0.4666666666666667
683671,Luis Hernandez,22,18,5,60,16,9,82,34,14,0.4146341463414634,0.4117647058823529,0.17073170731707318,0.2682926829268293,0.8181818181818182,0.2777777777777778,0.7317073170731707,0.26666666666666666,0.5625
683679,Jesus Rodriguez,156,114,17,227,66,27,383,180,44,0.4699738903394256,0.24444444444444444,0.11488250652741515,0.4073107049608355,0.7307692307692307,0.14912280701754385,0.5926892950391645,0.2907488986784141,0.4090909090909091
684081,Erick Brito,320,224,41,418,131,26,738,355,67,0.481029810298103,0.18873239436619718,0.09078590785907859,0.43360433604336046,0.7,0.18303571428571427,0.5663956639566395,0.3133971291866029,0.1984732824427481
684222,Jorge Burgos,604,373,76,847,273,70,1451,646,146,0.44521019986216404,0.2260061919504644,0.10062026188835287,0.4162646450723639,0.6175496688741722,0.2037533512064343,0.5837353549276361,0.32231404958677684,0.2564102564102564
684260,Jose  Estrada,9,8,2,10,3,1,19,11,3,0.5789473684210527,0.2727272727272727,0.15789473684210525,0.47368421052631576,0.8888888888888888,0.25,0.5263157894736842,0.3,0.3333333333333333
684491,Frank Rodriguez,307,223,31,268,91,47,575,314,78,0.5460869565217391,0.2484076433121019,0.1356521739130435,0.5339130434782609,0.7263843648208469,0.13901345291479822,0.46608695652173915,0.33955223880597013,0.5164835164835165
684495,Dyron Campos,2,2,1,8,4,2,10,6,3,0.6,0.5,0.3,0.2,1.0,0.5,0.8,0.5,0.5
684519,Omar De Los Santos,657,459,161,879,378,183,1536,837,344,0.544921875,0.4109916367980884,0.22395833333333334,0.427734375,0.6986301369863014,0.35076252723311546,0.572265625,0.4300341296928328,0.48412698412698413
684541,Sahid Valenzuela,245,158,26,144,40,16,389,198,42,0.5089974293059126,0.21212121212121213,0.10796915167095116,0.6298200514138818,0.6448979591836734,0.16455696202531644,0.37017994858611825,0.2777777777777778,0.4
684712,Wilber Sanchez,8,6,0,22,11,5,30,17,5,0.5666666666666667,0.29411764705882354,0.16666666666666666,0.26666666666666666,0.75,0.0,0.7333333333333333,0.5,0.45454545454545453
684715,Nic Kent,789,589,102,822,204,73,1611,793,175,0.49224084419615144,0.22068095838587642,0.10862818125387957,0.4897579143389199,0.7465145754119138,0.1731748726655348,0.5102420856610801,0.24817518248175183,0.35784313725490197
684852,Geraldo Quintero,666,472,94,1162,424,119,1828,896,213,0.49015317286652077,0.23772321428571427,0.11652078774617068,0.36433260393873085,0.7087087087087087,0.19915254237288135,0.6356673960612691,0.3648881239242685,0.2806603773584906
684855,Jared Dupere,681,483,163,714,276,152,1395,759,315,0.5440860215053763,0.4150197628458498,0.22580645161290322,0.4881720430107527,0.7092511013215859,0.33747412008281574,0.5118279569892473,0.3865546218487395,0.5507246376811594
684922,Dalton Shuffield,12,5,3,16,5,3,28,10,6,0.35714285714285715,0.6,0.21428571428571427,0.42857142857142855,0.4166666666666667,0.6,0.5714285714285714,0.3125,0.6
685091,Parker Chavers,45,22,3,35,11,3,80,33,6,0.4125,0.18181818181818182,0.075,0.5625,0.4888888888888889,0.13636363636363635,0.4375,0.3142857142857143,0.2727272727272727
685096,Scott McKeon,187,147,38,234,99,51,421,246,89,0.5843230403800475,0.3617886178861789,0.21140142517814728,0.44418052256532065,0.786096256684492,0.2585034013605442,0.5558194774346793,0.4230769230769231,0.5151515151515151
685133,Wade Meckler,148,95,9,160,29,8,308,124,17,0.4025974025974026,0.13709677419354838,0.05519480519480519,0.4805194805194805,0.6418918918918919,0.09473684210526316,0.5194805194805194,0.18125,0.27586206896551724
685274,Braiden Ward,473,311,49,538,123,41,1011,434,90,0.42927794263105834,0.2073732718894009,0.08902077151335312,0.4678536102868447,0.6575052854122622,0.15755627009646303,0.5321463897131553,0.22862453531598512,0.3333333333333333
685297,Cole Barr,47,26,8,47,13,8,94,39,16,0.4148936170212766,0.41025641025641024,0.1702127659574468,0.5,0.5531914893617021,0.3076923076923077,0.5,0.2765957446808511,0.6153846153846154
685300,Grant Richardson,594,388,141,583,183,87,1177,571,228,0.4851316907391674,0.39929947460595444,0.1937128292268479,0.5046728971962616,0.6531986531986532,0.3634020618556701,0.4953271028037383,0.313893653516295,0.47540983606557374
685332,Carlos Mendoza,499,285,44,479,109,28,978,394,72,0.40286298568507156,0.18274111675126903,0.0736196319018405,0.5102249488752556,0.5711422845691383,0.1543859649122807,0.4897750511247444,0.22755741127348644,0.25688073394495414
685376,Max Hewitt,279,158,37,265,62,32,544,220,69,0.40441176470588236,0.31363636363636366,0.12683823529411764,0.5128676470588235,0.5663082437275986,0.23417721518987342,0.48713235294117646,0.2339622641509434,0.5161290322580645
685460,Andrew Miller,142,107,30,241,77,35,383,184,65,0.4804177545691906,0.3532608695652174,0.16971279373368145,0.370757180156658,0.7535211267605634,0.2803738317757009,0.6292428198433421,0.31950207468879666,0.45454545454545453
685474,Felix Stevens,372,257,78,547,227,127,919,484,205,0.5266594124047879,0.42355371900826444,0.22306855277475518,0.4047878128400435,0.6908602150537635,0.3035019455252918,0.5952121871599565,0.4149908592321755,0.5594713656387665
685722,Michael Mantecon,11,7,0,4,2,1,15,9,1,0.6,0.1111111111111111,0.06666666666666667,0.7333333333333333,0.6363636363636364,0.0,0.26666666666666666,0.5,0.5
685744,Kenedy Corona,38,25,7,77,27,9,115,52,16,0.45217391304347826,0.3076923076923077,0.1391304347826087,0.33043478260869563,0.6578947368421053,0.28,0.6695652173913044,0.35064935064935066,0.3333333333333333
686340,Mario Fernandez,35,26,7,40,22,13,75,48,20,0.64,0.4166666666666667,0.26666666666666666,0.4666666666666667,0.7428571428571429,0.2692307692307692,0.5333333333333333,0.55,0.5909090909090909
686445,Sammy Siani,614,382,134,887,333,118,1501,715,252,0.4763491005996003,0.35244755244755244,0.16788807461692204,0.4090606262491672,0.6221498371335505,0.3507853403141361,0.5909393737508328,0.3754227733934611,0.35435435435435436
686499,Clark Elliott,548,318,68,362,68,21,910,386,89,0.42417582417582417,0.23056994818652848,0.0978021978021978,0.6021978021978022,0.5802919708029197,0.2138364779874214,0.3978021978021978,0.1878453038674033,0.3088235294117647
686531,Andre Lipcius,60,32,2,40,7,5,100,39,7,0.39,0.1794871794871795,0.07,0.6,0.5333333333333333,0.0625,0.4,0.175,0.7142857142857143
686546,Matthew Dyer,44,31,12,47,15,1,91,46,13,0.5054945054945055,0.2826086956521739,0.14285714285714285,0.4835164835164835,0.7045454545454546,0.3870967741935484,0.5164835164835165,0.3191489361702128,0.06666666666666667
686551,Christian Cairo,398,244,46,579,145,46,977,389,92,0.39815762538382804,0.2365038560411311,0.09416581371545547,0.40736949846468784,0.6130653266331658,0.1885245901639344,0.5926305015353122,0.2504317789291883,0.31724137931034485
686577,Keoni Cavaco,420,287,96,487,174,93,907,461,189,0.5082690187431091,0.40997830802603036,0.20837927232635062,0.46306504961411243,0.6833333333333333,0.3344947735191638,0.5369349503858876,0.35728952772073924,0.5344827586206896
686634,Chase Estep,545,306,76,669,200,62,1214,506,138,0.41680395387149916,0.2727272727272727,0.11367380560131796,0.4489291598023064,0.5614678899082569,0.24836601307189543,0.5510708401976936,0.29895366218236175,0.31
686673,Will Bartlett,447,252,72,846,240,83,1293,492,155,0.3805104408352668,0.3150406504065041,0.11987625676720805,0.345707656612529,0.5637583892617449,0.2857142857142857,0.654292343387471,0.28368794326241137,0.3458333333333333
686680,Ben Sems,502,355,87,580,158,54,1082,513,141,0.47412199630314233,0.27485380116959063,0.13031423290203328,0.46395563770794823,0.7071713147410359,0.24507042253521127,0.5360443622920518,0.27241379310344827,0.34177215189873417
686798,Yordys Valdes,525,337,74,688,253,88,1213,590,162,0.48639736191261335,0.2745762711864407,0.13355317394888705,0.43281121187139326,0.6419047619047619,0.2195845697329377,0.5671887881286067,0.36773255813953487,0.34782608695652173
686810,Brennan Milone,442,268,53,440,100,28,882,368,81,0.41723356009070295,0.22010869565217392,0.09183673469387756,0.5011337868480725,0.6063348416289592,0.19776119402985073,0.4988662131519274,0.22727272727272727,0.28
686843,Will Matthiessen,394,238,62,794,340,145,1188,578,207,0.48653198653198654,0.35813148788927335,0.17424242424242425,0.33164983164983164,0.6040609137055838,0.2605042016806723,0.6683501683501684,0.4282115869017632,0.4264705882352941
686846,Reggie Crawford,0,0,0,5,2,2,5,2,2,0.4,1.0,0.4,0.0,,,1.0,0.4,1.0
686863,Daniel Mateo,515,417,87,943,505,216,1458,922,303,0.6323731138545954,0.3286334056399132,0.20781893004115226,0.3532235939643347,0.8097087378640777,0.20863309352517986,0.6467764060356653,0.5355249204665959,0.4277227722772277
686948,Drake Baldwin,599,330,88,986,366,95,1585,696,183,0.4391167192429022,0.2629310344827586,0.11545741324921135,0.3779179810725552,0.5509181969949917,0.26666666666666666,0.6220820189274447,0.3711967545638945,0.25956284153005466
686976,Silas Ardoin,451,240,57,670,181,66,1121,421,123,0.37555753791257807,0.2921615201900237,0.10972346119536129,0.4023193577163247,0.532150776053215,0.2375,0.5976806422836753,0.2701492537313433,0.36464088397790057
686977,Bradlee Beesley,95,61,12,100,37,10,195,98,22,0.5025641025641026,0.22448979591836735,0.11282051282051282,0.48717948717948717,0.6421052631578947,0.19672131147540983,0.5128205128205128,0.37,0.2702702702702703
686981,Brenden Dixon,385,217,66,729,240,86,1114,457,152,0.4102333931777379,0.33260393873085337,0.13644524236983843,0.34560143626570916,0.5636363636363636,0.30414746543778803,0.6543985637342908,0.3292181069958848,0.35833333333333334
686982,Jared McKenzie,671,457,137,838,382,140,1509,839,277,0.5559973492379059,0.3301549463647199,0.18356527501656728,0.44466534128561963,0.6810730253353204,0.29978118161925604,0.5553346587143804,0.45584725536992843,0.36649214659685864
686984,Marcus Lee Sang,917,604,176,895,254,94,1812,858,270,0.4735099337748344,0.3146853146853147,0.1490066225165563,0.5060706401766004,0.658669574700109,0.2913907284768212,0.4939293598233996,0.2837988826815642,0.3700787401574803
687013,Cooper Uhl,44,30,11,41,9,4,85,39,15,0.4588235294117647,0.38461538461538464,0.17647058823529413,0.5176470588235295,0.6818181818181818,0.36666666666666664,0.4823529411764706,0.21951219512195122,0.4444444444444444
687036,Zach Zubia,519,243,46,770,145,45,1289,388,91,0.30100853374709075,0.2345360824742268,0.07059736229635376,0.4026377036462374,0.4682080924855491,0.18930041152263374,0.5973622963537626,0.18831168831168832,0.3103448275862069
687044,Ernie Yake,165,99,16,147,48,12,312,147,28,0.47115384615384615,0.19047619047619047,0.08974358974358974,0.5288461538461539,0.6,0.16161616161616163,0.47115384615384615,0.32653061224489793,0.25
687069,Josh Rivera,170,93,23,252,92,40,422,185,63,0.43838862559241704,0.34054054054054056,0.14928909952606634,0.4028436018957346,0.5470588235294118,0.24731182795698925,0.5971563981042654,0.36507936507936506,0.43478260869565216
687071,Shane Sasaki,451,292,70,675,221,65,1126,513,135,0.455595026642984,0.2631578947368421,0.11989342806394317,0.4005328596802842,0.647450110864745,0.23972602739726026,0.5994671403197158,0.3274074074074074,0.29411764705882354
687072,Jamari Baylor,191,141,43,237,50,31,428,191,74,0.4462616822429907,0.387434554973822,0.17289719626168223,0.4462616822429907,0.7382198952879581,0.3049645390070922,0.5537383177570093,0.2109704641350211,0.62
687073,Yan Contreras,83,60,22,156,58,33,239,118,55,0.49372384937238495,0.4661016949152542,0.2301255230125523,0.3472803347280335,0.7228915662650602,0.36666666666666664,0.6527196652719666,0.3717948717948718,0.5689655172413793
687084,Joshua Mears,407,279,104,527,146,84,934,425,188,0.4550321199143469,0.4423529411764706,0.2012847965738758,0.43576017130620986,0.6855036855036855,0.3727598566308244,0.5642398286937902,0.27703984819734345,0.5753424657534246
687125,Dilan Rosario,6,5,1,13,2,1,19,7,2,0.3684210526315789,0.2857142857142857,0.10526315789473684,0.3157894736842105,0.8333333333333334,0.2,0.6842105263157895,0.15384615384615385,0.5
687136,Spencer Henson,495,363,96,720,271,115,1215,634,211,0.5218106995884774,0.33280757097791797,0.17366255144032922,0.4074074074074074,0.7333333333333333,0.2644628099173554,0.5925925925925926,0.3763888888888889,0.42435424354243545
687152,Darrien Miller,626,350,78,869,244,51,1495,594,129,0.39732441471571905,0.21717171717171718,0.0862876254180602,0.4187290969899666,0.5591054313099042,0.22285714285714286,0.5812709030100335,0.2807825086306099,0.20901639344262296
687192,Cade Hunter,248,145,37,401,130,44,649,275,81,0.423728813559322,0.29454545454545455,0.12480739599383667,0.38212634822804314,0.5846774193548387,0.25517241379310346,0.6178736517719569,0.32418952618453867,0.3384615384615385
687201,Kevin Kilpatrick Jr.,729,414,106,1442,557,163,2171,971,269,0.44725932749884845,0.27703398558187436,0.1239060340856748,0.33578995854444954,0.5679012345679012,0.2560386473429952,0.6642100414555504,0.38626907073509015,0.2926391382405745
687206,Tres Gonzalez,718,380,62,1090,325,71,1808,705,133,0.3899336283185841,0.18865248226950354,0.07356194690265487,0.3971238938053097,0.5292479108635098,0.1631578947368421,0.6028761061946902,0.2981651376146789,0.21846153846153846
687208,Nathan Hickey,147,74,21,179,53,16,326,127,37,0.3895705521472393,0.29133858267716534,0.11349693251533742,0.450920245398773,0.5034013605442177,0.28378378378378377,0.549079754601227,0.29608938547486036,0.3018867924528302
687210,Nathan Martorella,833,484,113,981,260,70,1814,744,183,0.4101433296582139,0.24596774193548387,0.10088202866593164,0.4592061742006615,0.581032412965186,0.2334710743801653,0.5407938257993384,0.2650356778797146,0.2692307692307692
687221,Dalton Rushing,639,391,89,865,190,62,1504,581,151,0.3863031914893617,0.25989672977624784,0.10039893617021277,0.42486702127659576,0.6118935837245696,0.22762148337595908,0.5751329787234043,0.21965317919075145,0.3263157894736842
687248,Keshawn Ogans,653,421,84,1090,407,126,1743,828,210,0.4750430292598967,0.2536231884057971,0.12048192771084337,0.37464142283419394,0.6447166921898928,0.1995249406175772,0.6253585771658061,0.37339449541284403,0.3095823095823096
687282,Gabriel Rincones Jr.,559,345,95,643,191,52,1202,536,147,0.4459234608985025,0.27425373134328357,0.12229617304492513,0.4650582362728785,0.6171735241502684,0.2753623188405797,0.5349417637271214,0.29704510108864696,0.27225130890052357
687284,Thomas Gavello,217,150,48,252,74,45,469,224,93,0.47761194029850745,0.41517857142857145,0.19829424307036247,0.4626865671641791,0.6912442396313364,0.32,0.5373134328358209,0.29365079365079366,0.6081081081081081
687285,Troy Schreffler,112,65,14,131,34,20,243,99,34,0.4074074074074074,0.3434343434343434,0.13991769547325103,0.4609053497942387,0.5803571428571429,0.2153846153846154,0.5390946502057613,0.2595419847328244,0.5882352941176471
687315,Christian Pregent,25,13,4,55,29,13,80,42,17,0.525,0.40476190476190477,0.2125,0.3125,0.52,0.3076923076923077,0.6875,0.5272727272727272,0.4482758620689655
687346,Gabe Matthews,550,325,88,470,82,33,1020,407,121,0.3990196078431373,0.2972972972972973,0.11862745098039215,0.5392156862745098,0.5909090909090909,0.27076923076923076,0.46078431372549017,0.17446808510638298,0.4024390243902439
687363,Victor Scott II,510,350,69,596,197,47,1106,547,116,0.4945750452079566,0.21206581352833637,0.10488245931283906,0.46112115732368897,0.6862745098039216,0.19714285714285715,0.538878842676311,0.33053691275167785,0.23857868020304568
687394,Jack Brannigan,211,142,47,455,181,67,666,323,114,0.484984984984985,0.35294117647058826,0.17117117117117117,0.31681681681681684,0.6729857819905213,0.33098591549295775,0.6831831831831832,0.3978021978021978,0.3701657458563536
687426,Glenn Santiago,53,39,16,56,24,11,109,63,27,0.5779816513761468,0.42857142857142855,0.24770642201834864,0.48623853211009177,0.7358490566037735,0.41025641025641024,0.5137614678899083,0.42857142857142855,0.4583333333333333
687431,Hudson Head,313,218,65,373,131,44,686,349,109,0.5087463556851312,0.3123209169054441,0.1588921282798834,0.45626822157434405,0.6964856230031949,0.2981651376146789,0.543731778425656,0.3512064343163539,0.33587786259541985
687493,Luke Brown,377,257,76,516,195,58,893,452,134,0.5061590145576708,0.29646017699115046,0.15005599104143338,0.4221724524076148,0.6816976127320955,0.29571984435797666,0.5778275475923852,0.37790697674418605,0.29743589743589743
687515,Colby Thomas,501,363,102,366,125,67,867,488,169,0.5628604382929643,0.3463114754098361,0.19492502883506344,0.5778546712802768,0.7245508982035929,0.2809917355371901,0.42214532871972316,0.34153005464480873,0.536
687521,Eric Brown Jr.,395,210,35,684,226,46,1079,436,81,0.4040778498609824,0.18577981651376146,0.07506950880444857,0.366079703429101,0.5316455696202531,0.16666666666666666,0.633920296570899,0.3304093567251462,0.20353982300884957
687526,Marcus Smith,102,54,16,191,41,19,293,95,35,0.3242320819112628,0.3684210526315789,0.11945392491467577,0.34812286689419797,0.5294117647058824,0.2962962962962963,0.6518771331058021,0.21465968586387435,0.4634146341463415
687529,Grant McCray,1053,665,184,1227,334,159,2280,999,343,0.4381578947368421,0.3433433433433433,0.15043859649122807,0.4618421052631579,0.6315289648622981,0.27669172932330827,0.5381578947368421,0.2722086389568052,0.47604790419161674
687543,Andrew Jenkins,211,149,31,230,65,34,441,214,65,0.4852607709750567,0.3037383177570093,0.1473922902494331,0.47845804988662133,0.7061611374407583,0.2080536912751678,0.5215419501133787,0.2826086956521739,0.5230769230769231
687545,Blake Robertson,672,422,123,859,291,93,1531,713,216,0.46570868713259306,0.302945301542777,0.1410842586544742,0.4389288047028086,0.6279761904761905,0.2914691943127962,0.5610711952971914,0.33876600698486614,0.31958762886597936
687551,Drew Gilbert,162,100,29,200,70,15,362,170,44,0.4696132596685083,0.25882352941176473,0.12154696132596685,0.44751381215469616,0.6172839506172839,0.29,0.5524861878453039,0.35,0.21428571428571427
687553,Kamren James,363,240,70,524,196,68,887,436,138,0.4915445321307779,0.3165137614678899,0.1555806087936866,0.4092446448703495,0.6611570247933884,0.2916666666666667,0.5907553551296505,0.37404580152671757,0.3469387755102041
687554,DJ Gladney,570,441,105,902,425,207,1472,866,312,0.5883152173913043,0.36027713625866054,0.21195652173913043,0.38722826086956524,0.7736842105263158,0.23809523809523808,0.6127717391304348,0.47117516629711753,0.48705882352941177
687567,Jorel Ortega,421,283,72,613,197,88,1034,480,160,0.46421663442940037,0.3333333333333333,0.15473887814313347,0.4071566731141199,0.672209026128266,0.254416961130742,0.59284332688588,0.32137030995106036,0.4467005076142132
687597,Jordan Beck,548,386,78,735,211,103,1283,597,181,0.46531566640685895,0.30318257956448913,0.1410756040530008,0.4271239282930631,0.7043795620437956,0.20207253886010362,0.5728760717069369,0.2870748299319728,0.4881516587677725
687601,Wendell Marrero,189,123,50,236,76,41,425,199,91,0.4682352941176471,0.457286432160804,0.21411764705882352,0.4447058823529412,0.6507936507936508,0.4065040650406504,0.5552941176470588,0.3220338983050847,0.5394736842105263
687605,Andrew Pinckney,89,54,11,233,78,18,322,132,29,0.40993788819875776,0.2196969696969697,0.09006211180124224,0.27639751552795033,0.6067415730337079,0.2037037037037037,0.7236024844720497,0.33476394849785407,0.23076923076923078
687608,Liam Spence,190,95,26,257,66,31,447,161,57,0.36017897091722595,0.35403726708074534,0.12751677852348994,0.4250559284116331,0.5,0.2736842105263158,0.5749440715883669,0.25680933852140075,0.4696969696969697
687614,Parker Bates,45,28,12,48,18,2,93,46,14,0.4946236559139785,0.30434782608695654,0.15053763440860216,0.4838709677419355,0.6222222222222222,0.42857142857142855,0.5161290322580645,0.375,0.1111111111111111
687625,Kai Murphy,196,152,48,148,58,25,344,210,73,0.6104651162790697,0.3476190476190476,0.21220930232558138,0.5697674418604651,0.7755102040816326,0.3157894736842105,0.43023255813953487,0.3918918918918919,0.43103448275862066
687628,Justin Boyd,65,42,16,195,56,20,260,98,36,0.3769230769230769,0.3673469387755102,0.13846153846153847,0.25,0.6461538461538462,0.38095238095238093,0.75,0.28717948717948716,0.35714285714285715
687637,Dylan Beavers,734,426,75,775,216,53,1509,642,128,0.4254473161033797,0.19937694704049844,0.08482438701126574,0.48641484426772696,0.5803814713896458,0.176056338028169,0.513585155732273,0.2787096774193548,0.24537037037037038
687667,Luis Valdez,473,312,68,481,175,73,954,487,141,0.510482180293501,0.28952772073921973,0.14779874213836477,0.49580712788259956,0.6596194503171248,0.21794871794871795,0.5041928721174004,0.36382536382536385,0.41714285714285715
687749,Jase Bowen,625,452,135,1132,444,135,1757,896,270,0.5099601593625498,0.3013392857142857,0.15367103016505407,0.35571997723392146,0.7232,0.29867256637168144,0.6442800227660785,0.392226148409894,0.30405405405405406
687751,Cortland Lawson,100,68,19,190,73,28,290,141,47,0.4862068965517241,0.3333333333333333,0.16206896551724137,0.3448275862068966,0.68,0.27941176470588236,0.6551724137931034,0.38421052631578945,0.3835616438356164
687783,Matthew Wood,557,315,33,829,256,56,1386,571,89,0.411976911976912,0.15586690017513136,0.06421356421356421,0.4018759018759019,0.5655296229802513,0.10476190476190476,0.5981240981240982,0.3088057901085645,0.21875
687811,Chris Lanzilli,226,155,35,372,133,48,598,288,83,0.4816053511705686,0.2881944444444444,0.13879598662207357,0.3779264214046823,0.6858407079646017,0.22580645161290322,0.6220735785953178,0.3575268817204301,0.3609022556390977
687930,Tyresse Turner,57,41,15,83,31,14,140,72,29,0.5142857142857142,0.4027777777777778,0.20714285714285716,0.40714285714285714,0.7192982456140351,0.36585365853658536,0.5928571428571429,0.37349397590361444,0.45161290322580644
687942,Torin Montgomery,224,146,33,309,95,36,533,241,69,0.4521575984990619,0.2863070539419087,0.1294559099437148,0.4202626641651032,0.6517857142857143,0.22602739726027396,0.5797373358348968,0.3074433656957929,0.37894736842105264
688273,Joshua Day,525,374,87,726,245,120,1251,619,207,0.49480415667466027,0.3344103392568659,0.16546762589928057,0.4196642685851319,0.7123809523809523,0.232620320855615,0.580335731414868,0.33746556473829203,0.4897959183673469
688311,Drake Osborn,402,253,61,610,218,59,1012,471,120,0.4654150197628458,0.25477707006369427,0.11857707509881422,0.39723320158102765,0.6293532338308457,0.24110671936758893,0.6027667984189723,0.35737704918032787,0.2706422018348624
688363,Graham Pauley,348,204,38,360,116,30,708,320,68,0.4519774011299435,0.2125,0.096045197740113,0.4915254237288136,0.5862068965517241,0.18627450980392157,0.5084745762711864,0.32222222222222224,0.25862068965517243
688367,Tucker Mitchell,258,169,40,604,224,62,862,393,102,0.45591647331786544,0.2595419847328244,0.11832946635730858,0.29930394431554525,0.6550387596899225,0.23668639053254437,0.7006960556844548,0.3708609271523179,0.2767857142857143
688392,Terence Doston,305,185,40,450,153,26,755,338,66,0.447682119205298,0.1952662721893491,0.08741721854304636,0.40397350993377484,0.6065573770491803,0.21621621621621623,0.5960264900662252,0.34,0.16993464052287582
688403,Michael Sandle,534,343,98,827,325,114,1361,668,212,0.4908155767817781,0.31736526946107785,0.15576781778104334,0.3923585598824394,0.6423220973782772,0.2857142857142857,0.6076414401175606,0.39298669891172916,0.3507692307692308
688449,TT Bowens,30,21,11,41,13,6,71,34,17,0.4788732394366197,0.5,0.23943661971830985,0.4225352112676056,0.7,0.5238095238095238,0.5774647887323944,0.3170731707317073,0.46153846153846156
688457,Gavin Cross,807,483,138,811,272,101,1618,755,239,0.46662546353522866,0.3165562913907285,0.1477132262051916,0.49876390605686033,0.5985130111524164,0.2857142857142857,0.5012360939431397,0.3353884093711467,0.3713235294117647
688460,Josh Kasevich,583,347,31,782,216,46,1365,563,77,0.41245421245421243,0.13676731793960922,0.05641025641025641,0.4271062271062271,0.5951972555746141,0.0893371757925072,0.5728937728937729,0.27621483375959077,0.21296296296296297
688495,Mariano Ricciardi,42,33,3,35,16,2,77,49,5,0.6363636363636364,0.10204081632653061,0.06493506493506493,0.5454545454545454,0.7857142857142857,0.09090909090909091,0.45454545454545453,0.45714285714285713,0.125
688500,Stephen Paolini,383,243,84,588,224,99,971,467,183,0.48094747682801237,0.39186295503211993,0.18846549948506694,0.3944387229660144,0.6344647519582245,0.345679012345679,0.6055612770339855,0.38095238095238093,0.4419642857142857
688556,Brandon Parker,226,155,50,431,188,81,657,343,131,0.5220700152207002,0.3819241982507289,0.1993911719939117,0.3439878234398782,0.6858407079646017,0.3225806451612903,0.6560121765601218,0.4361948955916473,0.4308510638297872
688610,Toby Welk,33,20,4,71,28,9,104,48,13,0.46153846153846156,0.2708333333333333,0.125,0.3173076923076923,0.6060606060606061,0.2,0.6826923076923077,0.39436619718309857,0.32142857142857145
688658,Ernny Ordonez,289,199,73,458,208,85,747,407,158,0.5448460508701473,0.3882063882063882,0.21151271753681392,0.3868808567603748,0.6885813148788927,0.36683417085427134,0.6131191432396251,0.45414847161572053,0.40865384615384615
688780,Luke Gold,298,224,30,265,71,40,563,295,70,0.5239786856127886,0.23728813559322035,0.12433392539964476,0.5293072824156305,0.7516778523489933,0.13392857142857142,0.4706927175843694,0.2679245283018868,0.5633802816901409
688808,David Martin,261,170,22,301,58,17,562,228,39,0.40569395017793597,0.17105263157894737,0.0693950177935943,0.46441281138790036,0.6513409961685823,0.12941176470588237,0.5355871886120996,0.19269102990033224,0.29310344827586204
688815,Anthony Quirion,352,211,61,472,123,48,824,334,109,0.4053398058252427,0.3263473053892216,0.13228155339805825,0.42718446601941745,0.5994318181818182,0.2890995260663507,0.5728155339805825,0.2605932203389831,0.3902439024390244
688832,Carter Williams,161,109,26,117,31,14,278,140,40,0.5035971223021583,0.2857142857142857,0.14388489208633093,0.579136690647482,0.6770186335403726,0.23853211009174313,0.420863309352518,0.26495726495726496,0.45161290322580644
689041,Rhylan Thomas,213,137,9,305,104,7,518,241,16,0.46525096525096526,0.06639004149377593,0.03088803088803089,0.4111969111969112,0.6431924882629108,0.06569343065693431,0.5888030888030888,0.34098360655737703,0.0673076923076923
689047,Jacob Wetzel,417,232,55,485,142,44,902,374,99,0.4146341463414634,0.2647058823529412,0.10975609756097561,0.4623059866962306,0.5563549160671463,0.23706896551724138,0.5376940133037694,0.2927835051546392,0.30985915492957744
689134,Wyatt Hendrie,323,185,50,674,226,69,997,411,119,0.41223671013039115,0.2895377128953771,0.119358074222668,0.3239719157472417,0.5727554179566563,0.2702702702702703,0.6760280842527583,0.3353115727002967,0.3053097345132743
689141,Anthony Hall,196,137,52,214,80,23,410,217,75,0.5292682926829269,0.3456221198156682,0.18292682926829268,0.47804878048780486,0.6989795918367347,0.3795620437956204,0.5219512195121951,0.37383177570093457,0.2875
689200,Jacob Melton,646,428,88,843,309,96,1489,737,184,0.4949630624580255,0.2496607869742198,0.12357286769644056,0.4338482202820685,0.6625386996904025,0.205607476635514,0.5661517797179315,0.3665480427046263,0.3106796116504854
689216,Jalen Battles,339,225,72,608,221,63,947,446,135,0.470960929250264,0.30269058295964124,0.14255543822597677,0.3579725448785639,0.6637168141592921,0.32,0.6420274551214361,0.36348684210526316,0.2850678733031674
689256,Patrick Romeri,43,32,8,81,35,17,124,67,25,0.5403225806451613,0.373134328358209,0.20161290322580644,0.3467741935483871,0.7441860465116279,0.25,0.6532258064516129,0.43209876543209874,0.4857142857142857
689302,Karson Simas,239,156,37,440,149,58,679,305,95,0.4491899852724595,0.3114754098360656,0.13991163475699558,0.35198821796759944,0.6527196652719666,0.23717948717948717,0.6480117820324006,0.3386363636363636,0.38926174496644295
689328,Ashton Creal,75,57,20,179,63,36,254,120,56,0.47244094488188976,0.4666666666666667,0.2204724409448819,0.2952755905511811,0.76,0.3508771929824561,0.7047244094488189,0.35195530726256985,0.5714285714285714
689414,Liam Hicks,80,56,14,153,43,8,233,99,22,0.4248927038626609,0.2222222222222222,0.0944206008583691,0.34334763948497854,0.7,0.25,0.6566523605150214,0.28104575163398693,0.18604651162790697
689440,Christian Sepulveda,84,70,10,68,13,6,152,83,16,0.5460526315789473,0.1927710843373494,0.10526315789473684,0.5526315789473685,0.8333333333333334,0.14285714285714285,0.4473684210526316,0.19117647058823528,0.46153846153846156
689456,Austin Murr,616,391,59,490,121,29,1106,512,88,0.4629294755877034,0.171875,0.07956600361663653,0.5569620253164557,0.6347402597402597,0.15089514066496162,0.4430379746835443,0.24693877551020407,0.2396694214876033
689659,Ryan Hernandez,122,77,29,122,34,14,244,111,43,0.45491803278688525,0.38738738738738737,0.1762295081967213,0.5,0.6311475409836066,0.37662337662337664,0.5,0.2786885245901639,0.4117647058823529
689688,Ethan Workinger,293,191,57,444,183,73,737,374,130,0.5074626865671642,0.34759358288770054,0.17639077340569878,0.39755766621438265,0.6518771331058021,0.29842931937172773,0.6024423337856174,0.41216216216216217,0.3989071038251366
689763,Kyler Castillo,104,66,8,145,50,10,249,116,18,0.46586345381526106,0.15517241379310345,0.07228915662650602,0.41767068273092367,0.6346153846153846,0.12121212121212122,0.5823293172690763,0.3448275862068966,0.2
689878,Colin Burgess,27,19,2,44,14,6,71,33,8,0.4647887323943662,0.24242424242424243,0.11267605633802817,0.38028169014084506,0.7037037037037037,0.10526315789473684,0.6197183098591549,0.3181818181818182,0.42857142857142855
689880,Myles Emmerson,503,299,76,512,111,41,1015,410,117,0.4039408866995074,0.28536585365853656,0.11527093596059114,0.49556650246305417,0.5944333996023857,0.25418060200668896,0.5044334975369458,0.216796875,0.36936936936936937
689959,Caeden Trenkle,345,205,54,245,50,21,590,255,75,0.4322033898305085,0.29411764705882354,0.1271186440677966,0.5847457627118644,0.5942028985507246,0.2634146341463415,0.4152542372881356,0.20408163265306123,0.42
690022,Ryan Ritter,347,283,79,442,121,58,789,404,137,0.5120405576679341,0.33910891089108913,0.17363751584283904,0.43979721166032953,0.8155619596541787,0.2791519434628975,0.5602027883396705,0.2737556561085973,0.4793388429752066
690107,Jackson Glenn,227,156,34,370,114,33,597,270,67,0.45226130653266333,0.24814814814814815,0.11222780569514237,0.38023450586264657,0.6872246696035242,0.21794871794871795,0.6197654941373534,0.3081081081081081,0.2894736842105263
690214,Jarrod Watkins,70,48,9,66,19,7,136,67,16,0.49264705882352944,0.23880597014925373,0.11764705882352941,0.5147058823529411,0.6857142857142857,0.1875,0.4852941176470588,0.2878787878787879,0.3684210526315789
690291,Jace Jung,747,444,93,730,224,85,1477,668,178,0.45226811103588355,0.26646706586826346,0.12051455653351388,0.5057549085985105,0.5943775100401606,0.20945945945945946,0.4942450914014895,0.30684931506849317,0.3794642857142857
690350,Kyle Battle,75,43,17,86,24,15,161,67,32,0.4161490683229814,0.47761194029850745,0.19875776397515527,0.4658385093167702,0.5733333333333334,0.3953488372093023,0.5341614906832298,0.27906976744186046,0.625
690448,Mike Jarvis,346,254,69,636,259,78,982,513,147,0.5224032586558045,0.28654970760233917,0.14969450101832993,0.35234215885947046,0.7341040462427746,0.27165354330708663,0.6476578411405295,0.40723270440251574,0.30115830115830117
690469,Kyle Hayes,8,5,2,2,0,0,10,5,2,0.5,0.4,0.2,0.8,0.625,0.4,0.2,0.0,
690474,Tommy Sacco Jr.,724,383,107,999,305,80,1723,688,187,0.3993035403366222,0.27180232558139533,0.1085316308763784,0.4201973302379571,0.5290055248618785,0.2793733681462141,0.579802669762043,0.3053053053053053,0.26229508196721313
690622,Alex Erro,413,246,39,560,164,54,973,410,93,0.42137718396711205,0.22682926829268293,0.09558067831449127,0.4244604316546763,0.5956416464891041,0.15853658536585366,0.5755395683453237,0.29285714285714287,0.32926829268292684
690902,Ben Metzinger,534,289,64,1019,317,117,1553,606,181,0.39021249195106245,0.2986798679867987,0.11654861558274308,0.3438506117192531,0.5411985018726592,0.22145328719723184,0.656149388280747,0.31108930323846906,0.36908517350157727
690903,Lucas Dunn,788,524,130,1089,328,129,1877,852,259,0.4539158231220032,0.3039906103286385,0.13798614810868406,0.41981885988279166,0.6649746192893401,0.2480916030534351,0.5801811401172083,0.3011937557392103,0.3932926829268293
690914,Brody Moore,245,154,30,312,87,28,557,241,58,0.4326750448833034,0.24066390041493776,0.10412926391382406,0.4398563734290844,0.6285714285714286,0.19480519480519481,0.5601436265709157,0.27884615384615385,0.3218390804597701
690917,Parker Kelly,130,101,22,210,54,39,340,155,61,0.45588235294117646,0.3935483870967742,0.17941176470588235,0.38235294117647056,0.7769230769230769,0.21782178217821782,0.6176470588235294,0.2571428571428571,0.7222222222222222
690924,Braxton Fulford,258,181,43,311,101,45,569,282,88,0.4956063268892794,0.3120567375886525,0.1546572934973638,0.45342706502636204,0.7015503875968992,0.23756906077348067,0.546572934973638,0.3247588424437299,0.44554455445544555
690956,Werner Blakely,857,496,148,701,149,54,1558,645,202,0.413992297817715,0.31317829457364343,0.12965340179717585,0.5500641848523748,0.5787631271878646,0.29838709677419356,0.44993581514762515,0.21255349500713266,0.3624161073825503
690961,Enrique Bradfield Jr.,31,18,4,38,3,0,69,21,4,0.30434782608695654,0.19047619047619047,0.057971014492753624,0.4492753623188406,0.5806451612903226,0.2222222222222222,0.5507246376811594,0.07894736842105263,0.0
690976,Alex Freeland,871,569,157,986,255,112,1857,824,269,0.4437264404954227,0.32645631067961167,0.14485729671513192,0.46903607969843836,0.653272101033295,0.2759226713532513,0.5309639203015617,0.25862068965517243,0.4392156862745098
690983,Hunter Haas,112,56,16,199,62,23,311,118,39,0.37942122186495175,0.3305084745762712,0.12540192926045016,0.36012861736334406,0.5,0.2857142857142857,0.639871382636656,0.31155778894472363,0.3709677419354839
690985,Colby Halter,169,100,28,196,58,17,365,158,45,0.4328767123287671,0.2848101265822785,0.1232876712328767,0.46301369863013697,0.591715976331361,0.28,0.536986301369863,0.29591836734693877,0.29310344827586204
690988,Austin Hendrick,818,598,222,1082,410,189,1900,1008,411,0.5305263157894737,0.40773809523809523,0.2163157894736842,0.4305263157894737,0.7310513447432763,0.3712374581939799,0.5694736842105264,0.3789279112754159,0.4609756097560976
690991,Mac Horvath,39,19,7,35,12,3,74,31,10,0.4189189189189189,0.3225806451612903,0.13513513513513514,0.527027027027027,0.48717948717948717,0.3684210526315789,0.47297297297297297,0.34285714285714286,0.25
690992,Ed Howard,298,186,39,401,143,55,699,329,94,0.47067238912732473,0.2857142857142857,0.13447782546494993,0.4263233190271817,0.6241610738255033,0.20967741935483872,0.5736766809728183,0.3566084788029925,0.38461538461538464
691001,Robert Moore,819,545,118,1279,482,121,2098,1027,239,0.48951382268827454,0.23271665043816941,0.11391801715919923,0.390371782650143,0.6654456654456654,0.21651376146788992,0.6096282173498571,0.37685691946833466,0.25103734439834025
691002,Yohandy Morales,91,67,12,199,82,27,290,149,39,0.5137931034482759,0.26174496644295303,0.13448275862068965,0.3137931034482759,0.7362637362637363,0.1791044776119403,0.6862068965517242,0.4120603015075377,0.32926829268292684
691006,Kevin Parada,549,406,123,840,342,134,1389,748,257,0.5385169186465083,0.34358288770053474,0.18502519798416125,0.3952483801295896,0.7395264116575592,0.30295566502463056,0.6047516198704104,0.40714285714285714,0.391812865497076
691019,Kyle Teel,98,62,6,166,49,16,264,111,22,0.42045454545454547,0.1981981981981982,0.08333333333333333,0.3712121212121212,0.6326530612244898,0.0967741935483871,0.6287878787878788,0.29518072289156627,0.32653061224489793
691024,Cayden Wallace,775,528,122,845,262,92,1620,790,214,0.4876543209876543,0.2708860759493671,0.13209876543209875,0.4783950617283951,0.6812903225806451,0.23106060606060605,0.5216049382716049,0.31005917159763313,0.3511450381679389
691116,Jesus Ordonez,87,58,8,144,52,19,231,110,27,0.47619047619047616,0.24545454545454545,0.11688311688311688,0.37662337662337664,0.6666666666666666,0.13793103448275862,0.6233766233766234,0.3611111111111111,0.36538461538461536
691181,Emmanuel Rodriguez,943,482,136,982,222,80,1925,704,216,0.3657142857142857,0.3068181818181818,0.11220779220779221,0.48987012987012984,0.5111346765641569,0.2821576763485477,0.5101298701298701,0.22606924643584522,0.36036036036036034
691182,Adael Amador,441,291,21,537,119,27,978,410,48,0.41922290388548056,0.11707317073170732,0.049079754601226995,0.450920245398773,0.6598639455782312,0.07216494845360824,0.549079754601227,0.22160148975791433,0.226890756302521
691183,Kevin Made,630,408,73,794,227,81,1424,635,154,0.44592696629213485,0.24251968503937008,0.10814606741573034,0.44241573033707865,0.6476190476190476,0.17892156862745098,0.5575842696629213,0.2858942065491184,0.3568281938325991
691185,Max Acosta,534,376,88,1134,486,135,1668,862,223,0.5167865707434053,0.25870069605568446,0.13369304556354916,0.32014388489208634,0.704119850187266,0.23404255319148937,0.6798561151079137,0.42857142857142855,0.2777777777777778
691186,Arol Vera,1035,773,189,763,249,103,1798,1022,292,0.5684093437152391,0.2857142857142857,0.16240266963292546,0.5756395995550612,0.7468599033816425,0.2445019404915912,0.42436040044493883,0.32634338138925295,0.41365461847389556
691191,Jose Salas,667,438,102,631,206,75,1298,644,177,0.49614791987673346,0.2748447204968944,0.13636363636363635,0.5138674884437596,0.656671664167916,0.2328767123287671,0.4861325115562404,0.3264659270998415,0.3640776699029126
691267,Alex Ramirez,779,526,113,1266,404,135,2045,930,248,0.4547677261613692,0.26666666666666666,0.12127139364303179,0.38092909535452324,0.675224646983312,0.21482889733840305,0.6190709046454768,0.31911532385466035,0.3341584158415842
691268,Yiddi Cappe,820,594,107,944,394,147,1764,988,254,0.5600907029478458,0.25708502024291496,0.14399092970521543,0.46485260770975056,0.724390243902439,0.18013468013468015,0.5351473922902494,0.4173728813559322,0.3730964467005076
691269,Adrian Placencia,974,631,193,948,196,115,1922,827,308,0.4302809573361082,0.3724304715840387,0.16024973985431842,0.5067637877211238,0.6478439425051334,0.3058637083993661,0.49323621227887615,0.20675105485232068,0.5867346938775511
691283,Sheng-Ping Chen,356,244,56,542,149,62,898,393,118,0.4376391982182628,0.30025445292620867,0.13140311804008908,0.39643652561247217,0.6853932584269663,0.22950819672131148,0.6035634743875279,0.27490774907749077,0.4161073825503356
691284,Juan Corniel,258,190,29,273,89,34,531,279,63,0.5254237288135594,0.22580645161290322,0.11864406779661017,0.4858757062146893,0.7364341085271318,0.15263157894736842,0.5141242937853108,0.326007326007326,0.38202247191011235
691285,Junior Franco,436,316,66,507,160,69,943,476,135,0.5047720042417816,0.28361344537815125,0.14316012725344646,0.4623541887592789,0.7247706422018348,0.2088607594936709,0.5376458112407211,0.3155818540433925,0.43125
691369,Allan Castro,280,204,44,404,131,45,684,335,89,0.489766081871345,0.2656716417910448,0.1301169590643275,0.4093567251461988,0.7285714285714285,0.21568627450980393,0.5906432748538012,0.32425742574257427,0.3435114503816794
691385,Ronald Rosario,351,226,48,608,227,107,959,453,155,0.47236704900938475,0.34216335540838855,0.1616266944734098,0.3660062565172054,0.6438746438746439,0.21238938053097345,0.6339937434827946,0.37335526315789475,0.4713656387665198
691406,Junior Caminero,204,139,34,384,159,53,588,298,87,0.5068027210884354,0.29194630872483224,0.14795918367346939,0.3469387755102041,0.6813725490196079,0.2446043165467626,0.6530612244897959,0.4140625,0.3333333333333333
691442,Wilfred Veras,555,457,100,859,390,184,1414,847,284,0.599009900990099,0.33530106257378983,0.20084865629420084,0.3925035360678925,0.8234234234234235,0.2188183807439825,0.6074964639321075,0.4540162980209546,0.4717948717948718
691449,Roberto Campos,649,459,107,676,203,76,1325,662,183,0.499622641509434,0.2764350453172205,0.13811320754716983,0.489811320754717,0.7072419106317411,0.23311546840958605,0.510188679245283,0.30029585798816566,0.37438423645320196
691458,Blaze Jordan,379,253,49,680,299,84,1059,552,133,0.5212464589235127,0.24094202898550723,0.125590179414542,0.3578847969782814,0.6675461741424802,0.19367588932806323,0.6421152030217187,0.43970588235294117,0.2809364548494983
691558,Yeiner Fernandez,751,522,76,908,233,85,1659,755,161,0.4550934297769741,0.21324503311258278,0.0970464135021097,0.4526823387582881,0.6950732356857523,0.14559386973180077,0.5473176612417119,0.2566079295154185,0.3648068669527897
691579,Gabriel Rodriguez,12,7,2,7,2,1,19,9,3,0.47368421052631576,0.3333333333333333,0.15789473684210525,0.631578947368421,0.5833333333333334,0.2857142857142857,0.3684210526315789,0.2857142857142857,0.5
691594,Javier Sanoja,232,151,9,242,74,3,474,225,12,0.47468354430379744,0.05333333333333334,0.02531645569620253,0.48945147679324896,0.6508620689655172,0.059602649006622516,0.510548523206751,0.30578512396694213,0.04054054054054054
691598,Uziel Viloria,62,39,15,42,19,7,104,58,22,0.5576923076923077,0.3793103448275862,0.21153846153846154,0.5961538461538461,0.6290322580645161,0.38461538461538464,0.40384615384615385,0.4523809523809524,0.3684210526315789
691621,Jheremy Vargas,88,52,8,146,50,12,234,102,20,0.4358974358974359,0.19607843137254902,0.08547008547008547,0.37606837606837606,0.5909090909090909,0.15384615384615385,0.6239316239316239,0.3424657534246575,0.24
691645,Jefrey De Los Santos,9,5,2,10,4,1,19,9,3,0.47368421052631576,0.3333333333333333,0.15789473684210525,0.47368421052631576,0.5555555555555556,0.4,0.5263157894736842,0.4,0.25
691685,Jean Perez,65,55,10,50,18,12,115,73,22,0.6347826086956522,0.3013698630136986,0.19130434782608696,0.5652173913043478,0.8461538461538461,0.18181818181818182,0.43478260869565216,0.36,0.6666666666666666
691708,Junior Tilien,136,93,22,290,108,32,426,201,54,0.47183098591549294,0.26865671641791045,0.1267605633802817,0.3192488262910798,0.6838235294117647,0.23655913978494625,0.6807511737089202,0.3724137931034483,0.2962962962962963
691740,Daniel Susac,880,558,102,637,162,61,1517,720,163,0.47462096242584045,0.2263888888888889,0.1074489123269611,0.5800922874093606,0.634090909090909,0.1827956989247312,0.4199077125906394,0.2543171114599686,0.3765432098765432
691758,Erison Placencia,62,41,15,92,33,15,154,74,30,0.4805194805194805,0.40540540540540543,0.19480519480519481,0.4025974025974026,0.6612903225806451,0.36585365853658536,0.5974025974025974,0.358695652173913,0.45454545454545453
691775,Ryan Clifford,643,397,91,932,318,111,1575,715,202,0.45396825396825397,0.28251748251748254,0.12825396825396826,0.40825396825396826,0.6174183514774495,0.22921914357682618,0.5917460317460318,0.34120171673819744,0.3490566037735849
691777,Max Muncy,700,468,138,548,166,76,1248,634,214,0.5080128205128205,0.33753943217665616,0.17147435897435898,0.5608974358974359,0.6685714285714286,0.2948717948717949,0.4391025641025641,0.3029197080291971,0.4578313253012048
691781,Brady House,95,65,17,117,56,18,212,121,35,0.5707547169811321,0.2892561983471074,0.1650943396226415,0.4481132075471698,0.6842105263157895,0.26153846153846155,0.5518867924528302,0.47863247863247865,0.32142857142857145
691785,Marcelo Mayer,241,152,51,357,160,44,598,312,95,0.5217391304347826,0.30448717948717946,0.1588628762541806,0.40301003344481606,0.6307053941908713,0.3355263157894737,0.596989966555184,0.4481792717086835,0.275
691788,Joe Mack,885,598,163,997,314,95,1882,912,258,0.48459086078639746,0.28289473684210525,0.13708820403825717,0.47024442082890544,0.6757062146892655,0.2725752508361204,0.5297555791710946,0.3149448345035105,0.30254777070063693
691789,Izaac Pacheco,1099,700,198,942,293,123,2041,993,321,0.4865262126408623,0.32326283987915405,0.15727584517393434,0.5384615384615384,0.6369426751592356,0.28285714285714286,0.46153846153846156,0.31104033970276007,0.4197952218430034
691858,Jared Serna,174,127,16,232,72,23,406,199,39,0.49014778325123154,0.19597989949748743,0.0960591133004926,0.42857142857142855,0.7298850574712644,0.12598425196850394,0.5714285714285714,0.3103448275862069,0.3194444444444444
691907,Tsung-Che Cheng,454,268,43,491,160,49,945,428,92,0.45291005291005293,0.21495327102803738,0.09735449735449736,0.4804232804232804,0.5903083700440529,0.16044776119402984,0.5195767195767196,0.3258655804480652,0.30625
691938,Willy Vasquez,678,479,131,1025,371,136,1703,850,267,0.49911920140927774,0.31411764705882356,0.15678214914856137,0.3981209630064592,0.7064896755162242,0.27348643006263046,0.6018790369935408,0.3619512195121951,0.3665768194070081
691949,Jake Vogel,721,507,119,873,235,94,1594,742,213,0.465495608531995,0.28706199460916443,0.13362609786700125,0.4523212045169385,0.7031900138696255,0.23471400394477318,0.5476787954830615,0.26918671248568155,0.4
691988,Marcos De La Rosa,18,13,3,14,2,1,32,15,4,0.46875,0.26666666666666666,0.125,0.5625,0.7222222222222222,0.23076923076923078,0.4375,0.14285714285714285,0.5
692046,Axel Sanchez,414,317,84,711,249,133,1125,566,217,0.5031111111111111,0.3833922261484099,0.1928888888888889,0.368,0.7657004830917874,0.26498422712933756,0.632,0.350210970464135,0.5341365461847389
692221,Sammy Infante,108,67,16,160,54,26,268,121,42,0.45149253731343286,0.34710743801652894,0.15671641791044777,0.40298507462686567,0.6203703703703703,0.23880597014925373,0.5970149253731343,0.3375,0.48148148148148145
692225,Kristian Campbell,79,54,11,136,41,6,215,95,17,0.4418604651162791,0.17894736842105263,0.07906976744186046,0.3674418604651163,0.6835443037974683,0.2037037037037037,0.6325581395348837,0.3014705882352941,0.14634146341463414
692228,Caleb Pendleton,84,64,20,108,37,23,192,101,43,0.5260416666666666,0.42574257425742573,0.22395833333333334,0.4375,0.7619047619047619,0.3125,0.5625,0.3425925925925926,0.6216216216216216
692333,Jorge Puerta,8,6,3,8,0,0,16,6,3,0.375,0.5,0.1875,0.5,0.75,0.5,0.5,0.0,
692348,Aeverson Arteaga,863,610,120,1037,388,174,1900,998,294,0.5252631578947369,0.29458917835671344,0.15473684210526314,0.45421052631578945,0.7068366164542295,0.19672131147540983,0.5457894736842105,0.3741562198649952,0.4484536082474227
692366,Onil Perez,79,56,3,94,29,8,173,85,11,0.4913294797687861,0.12941176470588237,0.06358381502890173,0.45664739884393063,0.7088607594936709,0.05357142857142857,0.5433526011560693,0.30851063829787234,0.27586206896551724
692368,Adrian Sugastey,413,309,55,493,212,53,906,521,108,0.5750551876379691,0.2072936660268714,0.11920529801324503,0.45584988962472406,0.7481840193704601,0.1779935275080906,0.5441501103752759,0.4300202839756592,0.25
692397,Maikel Hernandez,5,4,1,5,0,0,10,4,1,0.4,0.25,0.1,0.5,0.8,0.25,0.5,0.0,
692405,Jeremy Rivas,780,544,100,982,297,105,1762,841,205,0.47729852440408627,0.2437574316290131,0.11634506242905789,0.4426787741203178,0.6974358974358974,0.18382352941176472,0.5573212258796821,0.3024439918533605,0.35353535353535354
692416,Christian Cerda,238,167,36,381,91,32,619,258,68,0.4168012924071082,0.26356589147286824,0.1098546042003231,0.38449111470113084,0.7016806722689075,0.2155688622754491,0.6155088852988692,0.2388451443569554,0.3516483516483517
692489,Angel Del Rosario,54,38,11,53,12,6,107,50,17,0.4672897196261682,0.34,0.1588785046728972,0.5046728971962616,0.7037037037037037,0.2894736842105263,0.4953271028037383,0.22641509433962265,0.5
692497,Estiven Machado,450,309,60,544,161,59,994,470,119,0.47283702213279677,0.2531914893617021,0.11971830985915492,0.45271629778672035,0.6866666666666666,0.1941747572815534,0.5472837022132797,0.2959558823529412,0.36645962732919257
692568,Miguel Ugueto,288,193,51,423,187,62,711,380,113,0.5344585091420534,0.29736842105263156,0.1589310829817159,0.4050632911392405,0.6701388888888888,0.26424870466321243,0.5949367088607594,0.44208037825059104,0.3315508021390374
692585,Yanquiel Fernandez,490,359,90,408,138,48,898,497,138,0.5534521158129176,0.2776659959758551,0.15367483296213807,0.5456570155902004,0.7326530612244898,0.25069637883008355,0.45434298440979953,0.3382352941176471,0.34782608695652173
692650,Carlos Amaya,110,87,24,68,34,18,178,121,42,0.6797752808988764,0.34710743801652894,0.23595505617977527,0.6179775280898876,0.7909090909090909,0.27586206896551724,0.38202247191011235,0.5,0.5294117647058824
693309,Isaiah Greene,337,210,65,558,189,68,895,399,133,0.44581005586592176,0.3333333333333333,0.14860335195530727,0.376536312849162,0.6231454005934718,0.30952380952380953,0.623463687150838,0.3387096774193548,0.35978835978835977
693459,Kyler Fedko,388,215,30,495,108,30,883,323,60,0.36579841449603623,0.18575851393188855,0.06795016987542468,0.43941109852774635,0.5541237113402062,0.13953488372093023,0.5605889014722537,0.21818181818181817,0.2777777777777778
693486,Erik Stock,234,143,20,374,115,34,608,258,54,0.4243421052631579,0.20930232558139536,0.08881578947368421,0.3848684210526316,0.6111111111111112,0.13986013986013987,0.6151315789473685,0.3074866310160428,0.2956521739130435
693809,Dilan Granadillo,1,1,0,2,0,0,3,1,0,0.3333333333333333,0.0,0.0,0.3333333333333333,1.0,0.0,0.6666666666666666,0.0,
693822,Murphy Stehly,154,115,15,281,96,38,435,211,53,0.4850574712643678,0.25118483412322273,0.12183908045977011,0.35402298850574715,0.7467532467532467,0.13043478260869565,0.6459770114942529,0.3416370106761566,0.3958333333333333
693850,Kala'i Rosario,976,525,155,1140,302,127,2116,827,282,0.3908317580340265,0.34099153567110035,0.1332703213610586,0.4612476370510397,0.5379098360655737,0.29523809523809524,0.5387523629489603,0.2649122807017544,0.4205298013245033
694025,Felix Reyes,58,41,10,63,27,4,121,68,14,0.5619834710743802,0.20588235294117646,0.11570247933884298,0.4793388429752066,0.7068965517241379,0.24390243902439024,0.5206611570247934,0.42857142857142855,0.14814814814814814
694201,Abel Bastidas,4,2,2,0,0,0,4,2,2,0.5,1.0,0.5,1.0,0.5,1.0,0.0,,
694208,Moises Ballesteros,372,253,59,403,146,38,775,399,97,0.5148387096774194,0.24310776942355888,0.12516129032258064,0.48,0.6801075268817204,0.233201581027668,0.52,0.36228287841191065,0.2602739726027397
694211,Manuel Pena,423,291,72,387,117,43,810,408,115,0.5037037037037037,0.2818627450980392,0.1419753086419753,0.5222222222222223,0.6879432624113475,0.24742268041237114,0.4777777777777778,0.3023255813953488,0.36752136752136755
694212,Samuel Basallo,205,126,39,181,60,17,386,186,56,0.48186528497409326,0.3010752688172043,0.14507772020725387,0.5310880829015544,0.6146341463414634,0.30952380952380953,0.4689119170984456,0.3314917127071823,0.2833333333333333
694214,Samuel Zavala,74,42,7,161,45,17,235,87,24,0.3702127659574468,0.27586206896551724,0.10212765957446808,0.3148936170212766,0.5675675675675675,0.16666666666666666,0.6851063829787234,0.2795031055900621,0.37777777777777777
694224,Gabriel Gonzalez,298,217,38,389,147,57,687,364,95,0.529839883551674,0.260989010989011,0.13828238719068414,0.43377001455604075,0.7281879194630873,0.17511520737327188,0.5662299854439592,0.37789203084832906,0.3877551020408163
694230,Hendry Mendez,396,251,45,531,199,51,927,450,96,0.4854368932038835,0.21333333333333335,0.10355987055016182,0.42718446601941745,0.6338383838383839,0.17928286852589642,0.5728155339805825,0.3747645951035782,0.2562814070351759
694246,Brad Malm,18,8,4,36,8,5,54,16,9,0.2962962962962963,0.5625,0.16666666666666666,0.3333333333333333,0.4444444444444444,0.5,0.6666666666666666,0.2222222222222222,0.625
694266,D'Andre Smith,365,247,61,571,217,82,936,464,143,0.49572649572649574,0.3081896551724138,0.1527777777777778,0.38995726495726496,0.6767123287671233,0.24696356275303644,0.6100427350427351,0.38003502626970226,0.3778801843317972
694271,R.J. Yeager,372,292,38,470,146,71,842,438,109,0.5201900237529691,0.24885844748858446,0.12945368171021376,0.4418052256532066,0.7849462365591398,0.13013698630136986,0.5581947743467933,0.31063829787234043,0.4863013698630137
694292,Jeffrey Wehler,106,78,12,189,61,17,295,139,29,0.4711864406779661,0.20863309352517986,0.09830508474576272,0.3593220338983051,0.7358490566037735,0.15384615384615385,0.6406779661016949,0.32275132275132273,0.2786885245901639
694336,Dom Johnson,265,169,45,319,97,53,584,266,98,0.4554794520547945,0.3684210526315789,0.1678082191780822,0.4537671232876712,0.6377358490566037,0.26627218934911245,0.5462328767123288,0.30407523510971785,0.5463917525773195
694351,Jacob Berry,574,404,83,678,255,76,1252,659,159,0.5263578274760383,0.24127465857359637,0.1269968051118211,0.4584664536741214,0.7038327526132404,0.20544554455445543,0.5415335463258786,0.37610619469026546,0.2980392156862745
694362,Blake Dunn,235,159,15,478,144,52,713,303,67,0.42496493688639553,0.22112211221122113,0.09396914446002805,0.32959326788218796,0.676595744680851,0.09433962264150944,0.6704067321178121,0.301255230125523,0.3611111111111111
694368,Jimmy Glowenke,161,111,26,214,65,20,375,176,46,0.4693333333333333,0.26136363636363635,0.12266666666666666,0.42933333333333334,0.6894409937888198,0.23423423423423423,0.5706666666666667,0.3037383177570093,0.3076923076923077
694371,Tommy Troy,154,99,15,232,64,29,386,163,44,0.422279792746114,0.26993865030674846,0.11398963730569948,0.39896373056994816,0.6428571428571429,0.15151515151515152,0.6010362694300518,0.27586206896551724,0.453125
694385,Brock Wilken,250,146,27,350,88,34,600,234,61,0.39,0.2606837606837607,0.10166666666666667,0.4166666666666667,0.584,0.18493150684931506,0.5833333333333334,0.25142857142857145,0.38636363636363635
694388,Joey Loperfido,57,40,8,72,28,8,129,68,16,0.5271317829457365,0.23529411764705882,0.12403100775193798,0.4418604651162791,0.7017543859649122,0.2,0.5581395348837209,0.3888888888888889,0.2857142857142857
694410,Gino Groover,133,102,9,204,59,15,337,161,24,0.47774480712166173,0.14906832298136646,0.0712166172106825,0.39465875370919884,0.7669172932330827,0.08823529411764706,0.6053412462908012,0.28921568627450983,0.2542372881355932
694425,Justice Bigbie,310,233,43,244,61,32,554,294,75,0.5306859205776173,0.25510204081632654,0.13537906137184116,0.5595667870036101,0.7516129032258064,0.18454935622317598,0.4404332129963899,0.25,0.5245901639344263
694478,Michael Turner,749,432,54,952,223,53,1701,655,107,0.3850676072898295,0.1633587786259542,0.06290417401528513,0.4403292181069959,0.5767690253671562,0.125,0.5596707818930041,0.2342436974789916,0.23766816143497757
694484,Max Wagner,554,354,90,855,241,104,1409,595,194,0.42228530872959547,0.32605042016806723,0.1376863023420866,0.39318665720369056,0.6389891696750902,0.2542372881355932,0.6068133427963094,0.2818713450292398,0.4315352697095436
694514,Sterlin Thompson,547,342,56,464,108,40,1011,450,96,0.44510385756676557,0.21333333333333335,0.09495548961424333,0.5410484668644906,0.6252285191956124,0.16374269005847952,0.4589515331355094,0.23275862068965517,0.37037037037037035
694661,Riley Tirotta,191,121,22,253,76,38,444,197,60,0.4436936936936937,0.30456852791878175,0.13513513513513514,0.43018018018018017,0.6335078534031413,0.18181818181818182,0.5698198198198198,0.30039525691699603,0.5
694671,Wyatt Langford,133,77,17,321,88,18,454,165,35,0.3634361233480176,0.21212121212121213,0.07709251101321586,0.29295154185022027,0.5789473684210527,0.22077922077922077,0.7070484581497798,0.27414330218068533,0.20454545454545456
694673,Abimelec Ortiz,487,293,91,801,336,105,1288,629,196,0.48835403726708076,0.31160572337042924,0.15217391304347827,0.3781055900621118,0.6016427104722792,0.310580204778157,0.6218944099378882,0.41947565543071164,0.3125
694762,Jake MacKenzie,27,13,7,59,17,10,86,30,17,0.3488372093023256,0.5666666666666667,0.19767441860465115,0.313953488372093,0.48148148148148145,0.5384615384615384,0.686046511627907,0.288135593220339,0.5882352941176471
694783,Casey Dana,372,286,113,400,139,82,772,425,195,0.5505181347150259,0.4588235294117647,0.25259067357512954,0.48186528497409326,0.7688172043010753,0.3951048951048951,0.5181347150259067,0.3475,0.5899280575539568
694808,Zach Kokoska,607,432,114,659,211,98,1266,643,212,0.5078988941548184,0.3297045101088647,0.1674565560821485,0.4794628751974723,0.7116968698517299,0.2638888888888889,0.5205371248025277,0.3201820940819423,0.46445497630331756
694815,Jack Hurley,134,101,31,152,62,31,286,163,62,0.5699300699300699,0.3803680981595092,0.21678321678321677,0.46853146853146854,0.753731343283582,0.3069306930693069,0.5314685314685315,0.40789473684210525,0.5
694876,Cooper Ingle,112,61,7,177,44,14,289,105,21,0.3633217993079585,0.2,0.0726643598615917,0.3875432525951557,0.5446428571428571,0.11475409836065574,0.6124567474048442,0.24858757062146894,0.3181818181818182
694943,Juan Gonzalez,11,7,4,5,2,1,16,9,5,0.5625,0.5555555555555556,0.3125,0.6875,0.6363636363636364,0.5714285714285714,0.3125,0.4,0.5
694976,Osvaldo Tovalin,775,527,94,844,305,74,1619,832,168,0.5138974675725757,0.20192307692307693,0.10376775787523163,0.47869054972205066,0.68,0.17836812144212524,0.5213094502779494,0.3613744075829384,0.24262295081967214
695020,Tanner Murray,14,13,6,34,10,2,48,23,8,0.4791666666666667,0.34782608695652173,0.16666666666666666,0.2916666666666667,0.9285714285714286,0.46153846153846156,0.7083333333333334,0.29411764705882354,0.2
695031,Joshua Zamora,508,346,39,621,220,64,1129,566,103,0.5013286093888397,0.18197879858657243,0.0912311780336581,0.449955713020372,0.6811023622047244,0.11271676300578035,0.550044286979628,0.35426731078904994,0.2909090909090909
695078,Jean Walters,53,42,7,35,17,8,88,59,15,0.6704545454545454,0.2542372881355932,0.17045454545454544,0.6022727272727273,0.7924528301886793,0.16666666666666666,0.3977272727272727,0.4857142857142857,0.47058823529411764
695299,Terrell Tatum,504,269,58,649,145,65,1153,414,123,0.3590633130962706,0.2971014492753623,0.10667823070251518,0.4371205550737207,0.5337301587301587,0.21561338289962825,0.5628794449262793,0.22342064714946072,0.4482758620689655
695312,Aaron Palensky,241,135,22,323,113,42,564,248,64,0.4397163120567376,0.25806451612903225,0.11347517730496454,0.42730496453900707,0.5601659751037344,0.16296296296296298,0.5726950354609929,0.3498452012383901,0.37168141592920356
695342,Colin Davis,116,88,16,179,53,24,295,141,40,0.47796610169491527,0.28368794326241137,0.13559322033898305,0.39322033898305087,0.7586206896551724,0.18181818181818182,0.6067796610169491,0.29608938547486036,0.4528301886792453
695358,Jonny Butler,629,385,74,435,90,26,1064,475,100,0.44642857142857145,0.21052631578947367,0.09398496240601503,0.5911654135338346,0.6120826709062003,0.19220779220779222,0.40883458646616544,0.20689655172413793,0.28888888888888886
695370,Thomas Francisco,664,473,98,703,235,62,1367,708,160,0.5179224579370885,0.22598870056497175,0.11704462326261887,0.4857351865398683,0.7123493975903614,0.20718816067653276,0.5142648134601316,0.33428165007112376,0.26382978723404255
695415,Bryson Worrell,37,17,7,67,24,9,104,41,16,0.3942307692307692,0.3902439024390244,0.15384615384615385,0.3557692307692308,0.4594594594594595,0.4117647058823529,0.6442307692307693,0.3582089552238806,0.375
695481,Jay Allen II,134,96,32,283,91,39,417,187,71,0.44844124700239807,0.37967914438502676,0.17026378896882494,0.3213429256594724,0.7164179104477612,0.3333333333333333,0.6786570743405276,0.3215547703180212,0.42857142857142855
695490,Edwin Arroyo,833,599,130,1055,381,126,1888,980,256,0.5190677966101694,0.2612244897959184,0.13559322033898305,0.4412076271186441,0.7190876350540216,0.21702838063439064,0.558792372881356,0.36113744075829385,0.33070866141732286
695508,Cameron Cauley,171,105,35,381,135,46,552,240,81,0.43478260869565216,0.3375,0.14673913043478262,0.30978260869565216,0.6140350877192983,0.3333333333333333,0.6902173913043478,0.3543307086614173,0.34074074074074073
695521,Gavin Conticello,58,45,11,71,22,7,129,67,18,0.5193798449612403,0.26865671641791045,0.13953488372093023,0.4496124031007752,0.7758620689655172,0.24444444444444444,0.5503875968992248,0.30985915492957744,0.3181818181818182
695578,James Wood,375,205,46,359,103,37,734,308,83,0.4196185286103542,0.2694805194805195,0.11307901907356949,0.510899182561308,0.5466666666666666,0.22439024390243903,0.4891008174386921,0.28690807799442897,0.3592233009708738
695587,Bryson Horne,436,300,108,688,349,113,1124,649,221,0.5774021352313167,0.3405238828967643,0.19661921708185054,0.3879003558718861,0.6880733944954128,0.36,0.6120996441281139,0.5072674418604651,0.3237822349570201
695600,Carter Jensen,1018,507,112,1015,255,80,2033,762,192,0.3748155435317265,0.25196850393700787,0.09444171175602557,0.5007378258730939,0.49803536345776034,0.22090729783037474,0.49926217412690604,0.2512315270935961,0.3137254901960784
695603,Benny Montgomery,849,568,110,1076,285,156,1925,853,266,0.44311688311688313,0.3118405627198124,0.13818181818181818,0.44103896103896106,0.6690223792697291,0.1936619718309859,0.558961038961039,0.2648698884758364,0.5473684210526316
695604,T.J. White,588,352,127,600,221,96,1188,573,223,0.4823232323232323,0.38917975567190227,0.18771043771043772,0.494949494949495,0.5986394557823129,0.36079545454545453,0.5050505050505051,0.36833333333333335,0.4343891402714932
695653,Noah Miller,1088,676,156,944,219,54,2032,895,210,0.4404527559055118,0.2346368715083799,0.10334645669291338,0.5354330708661418,0.6213235294117647,0.23076923076923078,0.4645669291338583,0.2319915254237288,0.2465753424657534
695657,Colson Montgomery,128,75,15,205,41,12,333,116,27,0.3483483483483483,0.23275862068965517,0.08108108108108109,0.3843843843843844,0.5859375,0.2,0.6156156156156156,0.2,0.2926829268292683
695670,Harry Ford,907,589,120,1468,337,123,2375,926,243,0.38989473684210524,0.26241900647948163,0.10231578947368421,0.3818947368421053,0.649393605292172,0.2037351443123939,0.6181052631578947,0.2295640326975477,0.3649851632047478
695734,Daylen Lile,283,201,54,343,135,41,626,336,95,0.536741214057508,0.28273809523809523,0.15175718849840256,0.4520766773162939,0.7102473498233216,0.26865671641791045,0.547923322683706,0.3935860058309038,0.3037037037037037
695735,Creed Willems,549,400,140,570,239,100,1119,639,240,0.5710455764075067,0.3755868544600939,0.21447721179624665,0.4906166219839142,0.7285974499089253,0.35,0.5093833780160858,0.4192982456140351,0.41841004184100417
695770,Wes Kath,704,521,218,804,299,180,1508,820,398,0.5437665782493368,0.4853658536585366,0.2639257294429708,0.46684350132625996,0.7400568181818182,0.418426103646833,0.53315649867374,0.3718905472636816,0.6020066889632107
695780,Jake Fox,771,453,88,956,340,85,1727,793,173,0.459177764910249,0.21815889029003782,0.10017371163867979,0.44643891140706427,0.5875486381322957,0.19426048565121412,0.5535610885929357,0.35564853556485354,0.25
695930,Frederick Bencosme,894,541,94,826,258,57,1720,799,151,0.4645348837209302,0.18898623279098872,0.0877906976744186,0.5197674418604651,0.6051454138702461,0.17375231053604437,0.48023255813953486,0.31234866828087166,0.22093023255813954
696030,Alejandro Osuna,463,303,55,741,273,77,1204,576,132,0.47840531561461797,0.22916666666666666,0.10963455149501661,0.3845514950166113,0.6544276457883369,0.18151815181518152,0.6154485049833887,0.3684210526315789,0.28205128205128205
696045,Yosy Galan,219,144,42,413,195,93,632,339,135,0.5363924050632911,0.39823008849557523,0.21360759493670886,0.34651898734177217,0.6575342465753424,0.2916666666666667,0.6534810126582279,0.4721549636803874,0.47692307692307695
696135,Kahlil Watson,643,424,111,757,205,81,1400,629,192,0.4492857142857143,0.3052464228934817,0.13714285714285715,0.4592857142857143,0.6594090202177294,0.2617924528301887,0.5407142857142857,0.27080581241743723,0.3951219512195122
696141,Ryan Wrobleski,462,372,101,629,297,116,1091,669,217,0.613198900091659,0.3243647234678625,0.19890009165902842,0.4234647112740605,0.8051948051948052,0.271505376344086,0.5765352887259395,0.47217806041335453,0.39057239057239057
696264,Tyler Whitaker,107,52,19,155,42,11,262,94,30,0.35877862595419846,0.3191489361702128,0.11450381679389313,0.4083969465648855,0.48598130841121495,0.36538461538461536,0.5916030534351145,0.2709677419354839,0.2619047619047619
696272,Maxwell Costes,239,149,32,342,130,39,581,279,71,0.4802065404475043,0.25448028673835127,0.12220309810671257,0.4113597246127367,0.6234309623430963,0.21476510067114093,0.5886402753872634,0.38011695906432746,0.3
696285,Jacob Young,386,232,41,512,164,43,898,396,84,0.44097995545657015,0.21212121212121213,0.0935412026726058,0.4298440979955457,0.6010362694300518,0.17672413793103448,0.5701559020044543,0.3203125,0.2621951219512195
696287,Ryan Higgins,400,261,64,553,187,68,953,448,132,0.4700944386149003,0.29464285714285715,0.1385099685204617,0.4197271773347324,0.6525,0.24521072796934865,0.5802728226652676,0.33815551537070526,0.36363636363636365
696487,Matt Higgins,219,152,39,225,61,29,444,213,68,0.4797297297297297,0.3192488262910798,0.15315315315315314,0.49324324324324326,0.6940639269406392,0.2565789473684211,0.5067567567567568,0.27111111111111114,0.47540983606557374
696521,Garrett Spain,643,463,122,747,255,96,1390,718,218,0.516546762589928,0.30362116991643456,0.15683453237410072,0.46258992805755395,0.7200622083981337,0.2634989200863931,0.537410071942446,0.3413654618473896,0.3764705882352941
698931,Kevin Guerrero,16,10,1,27,12,9,43,22,10,0.5116279069767442,0.45454545454545453,0.23255813953488372,0.37209302325581395,0.625,0.1,0.627906976744186,0.4444444444444444,0.75
699017,Wesley Zapata,7,5,2,26,11,4,33,16,6,0.48484848484848486,0.375,0.18181818181818182,0.21212121212121213,0.7142857142857143,0.4,0.7878787878787878,0.4230769230769231,0.36363636363636365
699065,Luis Guerra,92,62,16,52,15,7,144,77,23,0.5347222222222222,0.2987012987012987,0.1597222222222222,0.6388888888888888,0.6739130434782609,0.25806451612903225,0.3611111111111111,0.28846153846153844,0.4666666666666667
699112,Jose Serrano,38,32,9,64,25,16,102,57,25,0.5588235294117647,0.43859649122807015,0.24509803921568626,0.37254901960784315,0.8421052631578947,0.28125,0.6274509803921569,0.390625,0.64
699115,Carlos Jorge,124,88,23,182,78,27,306,166,50,0.5424836601307189,0.30120481927710846,0.16339869281045752,0.40522875816993464,0.7096774193548387,0.26136363636363635,0.5947712418300654,0.42857142857142855,0.34615384615384615
699302,Hector Rodriguez,68,60,11,79,48,19,147,108,30,0.7346938775510204,0.2777777777777778,0.20408163265306123,0.46258503401360546,0.8823529411764706,0.18333333333333332,0.5374149659863946,0.6075949367088608,0.3958333333333333
699471,Ivan Melendez,402,292,78,626,227,116,1028,519,194,0.504863813229572,0.3737957610789981,0.188715953307393,0.39105058365758755,0.7263681592039801,0.2671232876712329,0.6089494163424124,0.36261980830670926,0.5110132158590308
699625,Jimmy Crooks,857,514,137,883,247,79,1740,761,216,0.43735632183908046,0.28383705650459923,0.12413793103448276,0.4925287356321839,0.5997666277712952,0.26653696498054474,0.5074712643678161,0.2797281993204983,0.31983805668016196
700032,Victor Labrada,397,273,52,409,109,28,806,382,80,0.4739454094292804,0.2094240837696335,0.09925558312655088,0.49255583126550867,0.6876574307304786,0.19047619047619047,0.5074441687344913,0.2665036674816626,0.25688073394495414
700081,Jake Thompson,629,346,48,763,229,63,1392,575,111,0.4130747126436782,0.19304347826086957,0.07974137931034483,0.45186781609195403,0.5500794912559619,0.13872832369942195,0.548132183908046,0.30013106159895153,0.27510917030567683
700246,Carson Williams,715,431,134,1129,384,124,1844,815,258,0.4419739696312364,0.3165644171779141,0.1399132321041215,0.38774403470715835,0.6027972027972028,0.3109048723897912,0.6122559652928417,0.34012400354295835,0.3229166666666667
700250,Ben Rice,133,49,9,166,37,6,299,86,15,0.28762541806020064,0.1744186046511628,0.05016722408026756,0.44481605351170567,0.3684210526315789,0.1836734693877551,0.5551839464882943,0.22289156626506024,0.16216216216216217
700361,Shawn Goosenberg,581,396,54,1095,368,130,1676,764,184,0.45584725536992843,0.24083769633507854,0.10978520286396182,0.3466587112171838,0.6815834767641996,0.13636363636363635,0.6533412887828163,0.3360730593607306,0.3532608695652174
700652,Kenny Piper,366,251,79,679,227,69,1045,478,148,0.4574162679425837,0.30962343096234307,0.1416267942583732,0.35023923444976074,0.6857923497267759,0.3147410358565737,0.6497607655502392,0.33431516936671574,0.3039647577092511
700658,Chris Rotondo,246,151,23,411,111,44,657,262,67,0.3987823439878234,0.25572519083969464,0.1019786910197869,0.3744292237442922,0.6138211382113821,0.152317880794702,0.6255707762557078,0.27007299270072993,0.3963963963963964
700824,Freylin Minyety,164,99,16,174,37,11,338,136,27,0.40236686390532544,0.19852941176470587,0.07988165680473373,0.48520710059171596,0.6036585365853658,0.16161616161616163,0.514792899408284,0.21264367816091953,0.2972972972972973
700845,Adam Zebrowski,555,332,109,1004,358,139,1559,690,248,0.44259140474663244,0.35942028985507246,0.15907633098139834,0.3559974342527261,0.5981981981981982,0.32831325301204817,0.6440025657472739,0.3565737051792829,0.388268156424581
700931,Seth Stephenson,127,92,25,97,32,11,224,124,36,0.5535714285714286,0.2903225806451613,0.16071428571428573,0.5669642857142857,0.7244094488188977,0.2717391304347826,0.4330357142857143,0.32989690721649484,0.34375
700936,Collin Burns,166,118,35,194,55,13,360,173,48,0.48055555555555557,0.2774566473988439,0.13333333333333333,0.46111111111111114,0.7108433734939759,0.2966101694915254,0.5388888888888889,0.28350515463917525,0.23636363636363636
701106,Chase Valentine,37,25,3,43,12,7,80,37,10,0.4625,0.2702702702702703,0.125,0.4625,0.6756756756756757,0.12,0.5375,0.27906976744186046,0.5833333333333334
701158,Kobe Kato,553,307,58,676,195,37,1229,502,95,0.4084621643612693,0.1892430278884462,0.07729861676159479,0.4499593165174939,0.5551537070524413,0.18892508143322476,0.5500406834825061,0.28846153846153844,0.18974358974358974
701162,Ben Malgeri,127,94,14,95,20,10,222,114,24,0.5135135135135135,0.21052631578947367,0.10810810810810811,0.5720720720720721,0.7401574803149606,0.14893617021276595,0.42792792792792794,0.21052631578947367,0.5
701177,Nick Cimillo,83,45,18,217,84,25,300,129,43,0.43,0.3333333333333333,0.14333333333333334,0.27666666666666667,0.5421686746987951,0.4,0.7233333333333334,0.3870967741935484,0.2976190476190476
701209,Colton Bender,235,168,33,398,120,63,633,288,96,0.4549763033175355,0.3333333333333333,0.15165876777251186,0.3712480252764613,0.7148936170212766,0.19642857142857142,0.6287519747235387,0.3015075376884422,0.525
701295,Benjamin Blackwell,83,59,10,196,79,26,279,138,36,0.4946236559139785,0.2608695652173913,0.12903225806451613,0.2974910394265233,0.7108433734939759,0.1694915254237288,0.7025089605734767,0.4030612244897959,0.3291139240506329
701305,Zach Dezenzo,210,143,42,317,108,28,527,251,70,0.476280834914611,0.2788844621513944,0.13282732447817835,0.3984819734345351,0.680952380952381,0.2937062937062937,0.6015180265654649,0.34069400630914826,0.25925925925925924
701350,Roman Anthony,417,215,71,613,181,52,1030,396,123,0.3844660194174757,0.3106060606060606,0.11941747572815534,0.40485436893203886,0.5155875299760192,0.3302325581395349,0.5951456310679611,0.29526916802610115,0.287292817679558
701398,Sal Stewart,172,113,19,287,92,25,459,205,44,0.4466230936819172,0.2146341463414634,0.09586056644880174,0.3747276688453159,0.6569767441860465,0.168141592920354,0.6252723311546841,0.3205574912891986,0.2717391304347826
701496,Benjamin Cowles,690,426,99,1016,327,124,1706,753,223,0.4413833528722157,0.2961487383798141,0.13071512309495897,0.4044548651817116,0.6173913043478261,0.2323943661971831,0.5955451348182884,0.3218503937007874,0.37920489296636084
701538,Jackson Merrill,493,330,40,522,178,37,1015,508,77,0.5004926108374385,0.1515748031496063,0.07586206896551724,0.4857142857142857,0.6693711967545639,0.12121212121212122,0.5142857142857142,0.34099616858237547,0.20786516853932585
701544,Andy Blake,122,83,15,155,50,20,277,133,35,0.48014440433212996,0.2631578947368421,0.1263537906137184,0.4404332129963899,0.680327868852459,0.18072289156626506,0.5595667870036101,0.3225806451612903,0.4
701618,Damon Keith,710,471,129,973,270,124,1683,741,253,0.44028520499108736,0.34143049932523617,0.1503267973856209,0.42186571598336303,0.6633802816901408,0.27388535031847133,0.5781342840166369,0.2774922918807811,0.45925925925925926
701649,James Triantos,476,312,36,693,255,61,1169,567,97,0.48502994011976047,0.1710758377425044,0.08297690333618478,0.40718562874251496,0.6554621848739496,0.11538461538461539,0.592814371257485,0.36796536796536794,0.23921568627450981
701655,Reed Trimble,132,76,14,107,26,9,239,102,23,0.42677824267782427,0.22549019607843138,0.09623430962343096,0.5523012552301255,0.5757575757575758,0.18421052631578946,0.4476987447698745,0.24299065420560748,0.34615384615384615
701675,Nathan Church,866,532,71,1016,291,73,1882,823,144,0.43730074388947926,0.17496962332928312,0.0765143464399575,0.46014877789585545,0.6143187066974596,0.13345864661654136,0.5398512221041445,0.28641732283464566,0.2508591065292096
701678,Hao-Yu  Lee,534,374,71,705,187,60,1239,561,131,0.45278450363196127,0.23351158645276293,0.10573042776432606,0.43099273607748184,0.700374531835206,0.18983957219251338,0.5690072639225182,0.2652482269503546,0.32085561497326204
701800,Carlos Linarez,45,31,6,80,25,13,125,56,19,0.448,0.3392857142857143,0.152,0.36,0.6888888888888889,0.1935483870967742,0.64,0.3125,0.52
701817,River Town,679,350,45,655,168,40,1334,518,85,0.38830584707646176,0.1640926640926641,0.06371814092953523,0.5089955022488756,0.5154639175257731,0.12857142857142856,0.4910044977511244,0.2564885496183206,0.23809523809523808
701864,Griffin Doersching,72,52,15,141,57,28,213,109,43,0.5117370892018779,0.3944954128440367,0.20187793427230047,0.3380281690140845,0.7222222222222222,0.28846153846153844,0.6619718309859155,0.40425531914893614,0.49122807017543857
702042,Trendon Craig,137,97,24,150,45,15,287,142,39,0.49477351916376305,0.2746478873239437,0.13588850174216027,0.47735191637630664,0.708029197080292,0.24742268041237114,0.5226480836236934,0.3,0.3333333333333333
702068,Cole Gabrielson,55,31,8,83,29,12,138,60,20,0.43478260869565216,0.3333333333333333,0.14492753623188406,0.39855072463768115,0.5636363636363636,0.25806451612903225,0.6014492753623188,0.3493975903614458,0.41379310344827586
702110,Matt Suggs,158,112,34,313,141,56,471,253,90,0.5371549893842887,0.3557312252964427,0.1910828025477707,0.3354564755838641,0.7088607594936709,0.30357142857142855,0.6645435244161358,0.4504792332268371,0.3971631205673759
702112,Hogan Windish,717,488,127,1050,319,163,1767,807,290,0.4567062818336163,0.3593556381660471,0.16411997736276174,0.4057724957555178,0.6806136680613668,0.26024590163934425,0.5942275042444821,0.3038095238095238,0.5109717868338558
702113,Cole Cummings,124,85,26,137,37,11,261,122,37,0.4674329501915709,0.30327868852459017,0.1417624521072797,0.47509578544061304,0.6854838709677419,0.3058823529411765,0.524904214559387,0.27007299270072993,0.2972972972972973
702140,Ruben Ibarra,575,387,99,951,340,136,1526,727,235,0.4764089121887287,0.32324621733149933,0.15399737876802097,0.3768020969855832,0.6730434782608695,0.2558139534883721,0.6231979030144168,0.35751840168243953,0.4
702176,Alan Roden,483,273,32,652,145,21,1135,418,53,0.3682819383259912,0.12679425837320574,0.04669603524229075,0.42555066079295156,0.5652173913043478,0.11721611721611722,0.5744493392070484,0.2223926380368098,0.14482758620689656
702217,Will McGillis,92,73,14,105,30,15,197,103,29,0.5228426395939086,0.2815533980582524,0.14720812182741116,0.467005076142132,0.7934782608695652,0.1917808219178082,0.5329949238578681,0.2857142857142857,0.5
702222,Justin Crawford,115,91,17,153,67,13,268,158,30,0.5895522388059702,0.189873417721519,0.11194029850746269,0.4291044776119403,0.7913043478260869,0.18681318681318682,0.5708955223880597,0.43790849673202614,0.19402985074626866
702250,Jared Carr,710,447,116,743,229,73,1453,676,189,0.465244322092223,0.27958579881656803,0.13007570543702685,0.48864418444597385,0.6295774647887324,0.2595078299776286,0.5113558155540262,0.3082099596231494,0.31877729257641924
702261,Termarr Johnson,208,135,42,344,105,39,552,240,81,0.43478260869565216,0.3375,0.14673913043478262,0.37681159420289856,0.6490384615384616,0.3111111111111111,0.6231884057971014,0.30523255813953487,0.37142857142857144
702284,Cole Young,377,233,38,496,119,40,873,352,78,0.4032073310423826,0.2215909090909091,0.08934707903780069,0.43184421534937,0.6180371352785146,0.1630901287553648,0.56815578465063,0.2399193548387097,0.33613445378151263
702292,Chase Luttrell,105,74,16,98,31,12,203,105,28,0.5172413793103449,0.26666666666666666,0.13793103448275862,0.5172413793103449,0.7047619047619048,0.21621621621621623,0.4827586206896552,0.3163265306122449,0.3870967741935484
702315,Bennett Hostetler,53,35,6,73,30,10,126,65,16,0.5158730158730159,0.24615384615384617,0.12698412698412698,0.42063492063492064,0.660377358490566,0.17142857142857143,0.5793650793650794,0.410958904109589,0.3333333333333333
702328,Wade Stauss,12,6,1,1,0,0,13,6,1,0.46153846153846156,0.16666666666666666,0.07692307692307693,0.9230769230769231,0.5,0.16666666666666666,0.07692307692307693,0.0,
702331,Noah Mendlinger,72,40,4,154,35,4,226,75,8,0.33185840707964603,0.10666666666666667,0.035398230088495575,0.3185840707964602,0.5555555555555556,0.1,0.6814159292035398,0.22727272727272727,0.11428571428571428
702332,Caleb Durbin,159,88,12,178,49,12,337,137,24,0.4065281899109792,0.17518248175182483,0.0712166172106825,0.47181008902077154,0.5534591194968553,0.13636363636363635,0.5281899109792285,0.2752808988764045,0.24489795918367346
702333,Haydn McGeary,196,121,26,176,49,17,372,170,43,0.45698924731182794,0.2529411764705882,0.11559139784946236,0.5268817204301075,0.6173469387755102,0.21487603305785125,0.4731182795698925,0.2784090909090909,0.3469387755102041
702358,Trey Lipscomb,330,241,59,434,188,60,764,429,119,0.5615183246073299,0.2773892773892774,0.15575916230366493,0.4319371727748691,0.7303030303030303,0.24481327800829875,0.5680628272251309,0.43317972350230416,0.3191489361702128
702457,Colby Smelley,143,105,24,250,70,30,393,175,54,0.44529262086513993,0.30857142857142855,0.13740458015267176,0.3638676844783715,0.7342657342657343,0.22857142857142856,0.6361323155216285,0.28,0.42857142857142855
702463,Aaron McKeithan,454,289,27,586,145,34,1040,434,61,0.4173076923076923,0.14055299539170507,0.058653846153846154,0.43653846153846154,0.6365638766519823,0.09342560553633218,0.5634615384615385,0.24744027303754265,0.23448275862068965
702472,Austin Callahan,643,459,148,826,330,115,1469,789,263,0.5371000680735194,0.3333333333333333,0.17903335602450646,0.43771272974812797,0.713841368584759,0.3224400871459695,0.562287270251872,0.39951573849878935,0.3484848484848485
702478,Justin Guerrera,66,47,17,97,40,24,163,87,41,0.5337423312883436,0.47126436781609193,0.25153374233128833,0.4049079754601227,0.7121212121212122,0.3617021276595745,0.5950920245398773,0.41237113402061853,0.6
702518,Jett Williams,212,115,17,437,90,24,649,205,41,0.31587057010785824,0.2,0.06317411402157165,0.3266563944530046,0.5424528301886793,0.14782608695652175,0.6733436055469953,0.20594965675057209,0.26666666666666666
702540,Mikey Romero,16,12,4,21,7,4,37,19,8,0.5135135135135135,0.42105263157894735,0.21621621621621623,0.43243243243243246,0.75,0.3333333333333333,0.5675675675675675,0.3333333333333333,0.5714285714285714
702544,Jacob Reimer,110,68,16,249,69,23,359,137,39,0.3816155988857939,0.2846715328467153,0.10863509749303621,0.3064066852367688,0.6181818181818182,0.23529411764705882,0.6935933147632312,0.27710843373493976,0.3333333333333333
702616,Jackson Holliday,511,251,50,537,126,44,1048,377,94,0.3597328244274809,0.2493368700265252,0.08969465648854962,0.48759541984732824,0.4911937377690802,0.199203187250996,0.5124045801526718,0.2346368715083799,0.3492063492063492
702690,Cutter Coffey,102,61,15,215,53,17,317,114,32,0.35962145110410093,0.2807017543859649,0.10094637223974763,0.3217665615141956,0.5980392156862745,0.2459016393442623,0.6782334384858044,0.24651162790697675,0.32075471698113206
702789,Austin Gauthier,249,154,20,522,125,31,771,279,51,0.36186770428015563,0.1827956989247312,0.06614785992217899,0.3229571984435798,0.6184738955823293,0.12987012987012986,0.6770428015564203,0.23946360153256704,0.248
702920,Konner Piotto,30,20,5,30,12,3,60,32,8,0.5333333333333333,0.25,0.13333333333333333,0.5,0.6666666666666666,0.25,0.5,0.4,0.25
703070,Loidel Chapelli,855,550,126,973,279,118,1828,829,244,0.4535010940919037,0.2943305186972256,0.13347921225382933,0.46772428884026257,0.6432748538011696,0.2290909090909091,0.5322757111597374,0.2867420349434738,0.4229390681003584
703245,Andres Sosa,153,88,12,206,65,23,359,153,35,0.42618384401114207,0.22875816993464052,0.09749303621169916,0.42618384401114207,0.5751633986928104,0.13636363636363635,0.5738161559888579,0.3155339805825243,0.35384615384615387
703920,Alsander Womack,85,50,4,160,53,9,245,103,13,0.4204081632653061,0.1262135922330097,0.053061224489795916,0.3469387755102041,0.5882352941176471,0.08,0.6530612244897959,0.33125,0.16981132075471697
800050,Chase DeLauter,288,178,26,360,117,21,648,295,47,0.45524691358024694,0.15932203389830507,0.07253086419753087,0.4444444444444444,0.6180555555555556,0.14606741573033707,0.5555555555555556,0.325,0.1794871794871795
800060,Xavier Isaac,111,77,21,107,21,8,218,98,29,0.44954128440366975,0.29591836734693877,0.13302752293577982,0.5091743119266054,0.6936936936936937,0.2727272727272727,0.4908256880733945,0.19626168224299065,0.38095238095238093
800325,Luis Lara,128,92,16,149,45,12,277,137,28,0.49458483754512633,0.20437956204379562,0.10108303249097472,0.4620938628158845,0.71875,0.17391304347826086,0.5379061371841155,0.30201342281879195,0.26666666666666666
800683,Blake Rambusch,517,249,31,765,152,50,1282,401,81,0.312792511700468,0.20199501246882792,0.06318252730109204,0.4032761310452418,0.4816247582205029,0.12449799196787148,0.5967238689547582,0.19869281045751633,0.32894736842105265
800765,Carter Howell,603,374,60,725,198,70,1328,572,130,0.4307228915662651,0.22727272727272727,0.09789156626506024,0.45406626506024095,0.6202321724709784,0.16042780748663102,0.545933734939759,0.2731034482758621,0.35353535353535354
800959,Nick Goodwin,45,34,10,49,8,4,94,42,14,0.44680851063829785,0.3333333333333333,0.14893617021276595,0.4787234042553192,0.7555555555555555,0.29411764705882354,0.5212765957446809,0.16326530612244897,0.5
801039,John Garcia,139,96,23,198,54,19,337,150,42,0.44510385756676557,0.28,0.12462908011869436,0.4124629080118694,0.6906474820143885,0.23958333333333334,0.5875370919881305,0.2727272727272727,0.35185185185185186
801442,Jack Pineda,555,314,76,616,162,52,1171,476,128,0.40649017933390263,0.2689075630252101,0.10930828351836037,0.4739538855678907,0.5657657657657658,0.24203821656050956,0.5260461144321094,0.262987012987013,0.32098765432098764
801464,Andrew Pintar,249,178,35,344,93,37,593,271,72,0.45699831365935917,0.2656826568265683,0.12141652613827993,0.41989881956155145,0.714859437751004,0.19662921348314608,0.5801011804384486,0.2703488372093023,0.3978494623655914
801471,Austin Deming,139,86,30,241,85,29,380,171,59,0.45,0.34502923976608185,0.15526315789473685,0.36578947368421055,0.6187050359712231,0.3488372093023256,0.6342105263157894,0.35269709543568467,0.3411764705882353
801501,Nate Furman,430,232,26,650,164,18,1080,396,44,0.36666666666666664,0.1111111111111111,0.040740740740740744,0.39814814814814814,0.5395348837209303,0.11206896551724138,0.6018518518518519,0.2523076923076923,0.10975609756097561
801600,Bryce Willits,179,113,19,241,72,19,420,185,38,0.44047619047619047,0.20540540540540542,0.09047619047619047,0.4261904761904762,0.6312849162011173,0.168141592920354,0.5738095238095238,0.2987551867219917,0.2638888888888889
801670,Mike Boeve,155,87,13,191,42,17,346,129,30,0.37283236994219654,0.23255813953488372,0.08670520231213873,0.4479768786127168,0.5612903225806452,0.14942528735632185,0.5520231213872833,0.2198952879581152,0.40476190476190477
802355,Tanner Schobel,696,421,60,719,145,46,1415,566,106,0.4,0.1872791519434629,0.07491166077738516,0.49187279151943464,0.6048850574712644,0.14251781472684086,0.5081272084805654,0.20166898470097358,0.31724137931034485
802407,Joe Lampe,773,480,92,950,336,82,1723,816,174,0.473592571096924,0.21323529411764705,0.10098665118978525,0.4486360998258851,0.6209573091849935,0.19166666666666668,0.551363900174115,0.35368421052631577,0.24404761904761904
802415,Chandler Simpson,165,100,7,172,44,6,337,144,13,0.42729970326409494,0.09027777777777778,0.03857566765578635,0.4896142433234421,0.6060606060606061,0.07,0.5103857566765578,0.2558139534883721,0.13636363636363635
803009,Jack Alexander,330,207,44,398,142,61,728,349,105,0.4793956043956044,0.3008595988538682,0.14423076923076922,0.4532967032967033,0.6272727272727273,0.21256038647342995,0.5467032967032966,0.35678391959798994,0.4295774647887324
803033,Matthew Etzel,24,17,3,32,6,0,56,23,3,0.4107142857142857,0.13043478260869565,0.05357142857142857,0.42857142857142855,0.7083333333333334,0.17647058823529413,0.5714285714285714,0.1875,0.0
803288,Andrew Kachel,62,41,4,81,22,10,143,63,14,0.4405594405594406,0.2222222222222222,0.0979020979020979,0.43356643356643354,0.6612903225806451,0.0975609756097561,0.5664335664335665,0.2716049382716049,0.45454545454545453
804240,Jacob Burke,356,247,46,545,182,72,901,429,118,0.47613762486126526,0.27505827505827507,0.1309655937846837,0.3951165371809101,0.6938202247191011,0.1862348178137652,0.6048834628190899,0.3339449541284404,0.3956043956043956
804588,Chris Alleyne,687,490,141,844,239,94,1531,729,235,0.4761593729588504,0.3223593964334705,0.1534944480731548,0.4487263226649249,0.7132459970887919,0.28775510204081634,0.5512736773350752,0.283175355450237,0.39330543933054396
804596,Matt Donlan,6,2,0,20,4,2,26,6,2,0.23076923076923078,0.3333333333333333,0.07692307692307693,0.23076923076923078,0.3333333333333333,0.0,0.7692307692307693,0.2,0.5
804668,Rafael Flores,788,441,111,958,296,106,1746,737,217,0.42210767468499427,0.2944369063772049,0.12428407789232532,0.4513172966781214,0.5596446700507615,0.25170068027210885,0.5486827033218786,0.3089770354906054,0.3581081081081081
804858,Bryan Rincon,132,75,13,154,28,3,286,103,16,0.36013986013986016,0.1553398058252427,0.055944055944055944,0.46153846153846156,0.5681818181818182,0.17333333333333334,0.5384615384615384,0.18181818181818182,0.10714285714285714
805234,Tyler Robertson,79,60,14,155,71,35,234,131,49,0.5598290598290598,0.37404580152671757,0.2094017094017094,0.33760683760683763,0.759493670886076,0.23333333333333334,0.6623931623931624,0.45806451612903226,0.49295774647887325
805249,Otto Kemp,204,146,42,235,66,28,439,212,70,0.48291571753986334,0.330188679245283,0.15945330296127563,0.4646924829157175,0.7156862745098039,0.2876712328767123,0.5353075170842825,0.28085106382978725,0.42424242424242425
805268,Peyton Williams,212,133,49,295,108,34,507,241,83,0.47534516765285995,0.34439834024896265,0.16370808678500987,0.4181459566074951,0.6273584905660378,0.3684210526315789,0.5818540433925049,0.36610169491525424,0.3148148148148148
805280,Alex Iadisernia,411,266,63,510,187,69,921,453,132,0.49185667752442996,0.2913907284768212,0.14332247557003258,0.44625407166123776,0.6472019464720195,0.23684210526315788,0.5537459283387622,0.36666666666666664,0.3689839572192513
805300,Jakob Marsee,872,528,81,1141,284,40,2013,812,121,0.40337804272230504,0.14901477832512317,0.060109289617486336,0.43318430203676106,0.6055045871559633,0.1534090909090909,0.5668156979632389,0.24890446976336547,0.14084507042253522
805332,Justin Janas,222,154,34,344,157,39,566,311,73,0.549469964664311,0.2347266881028939,0.12897526501766785,0.392226148409894,0.6936936936936937,0.22077922077922077,0.607773851590106,0.4563953488372093,0.2484076433121019
805346,Ben Ross,820,564,131,911,255,111,1731,819,242,0.4731369150779896,0.2954822954822955,0.13980358174465626,0.4737146158290006,0.6878048780487804,0.2322695035460993,0.5262853841709995,0.27991218441273324,0.43529411764705883
805367,Chase Meidroth,171,69,13,297,76,17,468,145,30,0.30982905982905984,0.20689655172413793,0.0641025641025641,0.36538461538461536,0.40350877192982454,0.18840579710144928,0.6346153846153846,0.2558922558922559,0.2236842105263158
805373,Ignacio Alvarez,730,435,72,1264,417,85,1994,852,157,0.4272818455366098,0.18427230046948356,0.07873620862587763,0.36609829488465395,0.5958904109589042,0.16551724137931034,0.633901705115346,0.3299050632911392,0.2038369304556355
805672,Collin Price,344,179,44,538,196,60,882,375,104,0.42517006802721086,0.2773333333333333,0.11791383219954649,0.3900226757369615,0.5203488372093024,0.24581005586592178,0.6099773242630385,0.3643122676579926,0.30612244897959184
805779,Jacob Wilson,159,109,12,149,43,6,308,152,18,0.4935064935064935,0.11842105263157894,0.05844155844155844,0.5162337662337663,0.6855345911949685,0.11009174311926606,0.4837662337662338,0.28859060402684567,0.13953488372093023
805834,Javier Vaz,798,407,35,764,145,14,1562,552,49,0.353393085787452,0.08876811594202899,0.03137003841229193,0.5108834827144686,0.5100250626566416,0.085995085995086,0.48911651728553135,0.18979057591623036,0.09655172413793103
805842,Brett Johnson,242,140,48,265,53,23,507,193,71,0.3806706114398422,0.36787564766839376,0.14003944773175542,0.47731755424063116,0.5785123966942148,0.34285714285714286,0.5226824457593688,0.2,0.4339622641509434
805891,Taylor Young,959,545,69,1325,230,78,2284,775,147,0.3393169877408056,0.1896774193548387,0.06436077057793345,0.419877408056042,0.5683003128258602,0.12660550458715597,0.580122591943958,0.17358490566037735,0.3391304347826087
805904,Zach Cole ,320,191,73,361,112,51,681,303,124,0.44493392070484583,0.40924092409240925,0.18208516886930984,0.4698972099853157,0.596875,0.38219895287958117,0.5301027900146843,0.31024930747922436,0.45535714285714285
805957,Caleb Farmer,283,189,48,408,131,63,691,320,111,0.4630969609261939,0.346875,0.16063675832127353,0.40955137481910275,0.6678445229681979,0.25396825396825395,0.5904486251808972,0.32107843137254904,0.48091603053435117
806005,Ryan McCarty,222,165,30,384,110,49,606,275,79,0.4537953795379538,0.2872727272727273,0.13036303630363036,0.36633663366336633,0.7432432432432432,0.18181818181818182,0.6336633663366337,0.2864583333333333,0.44545454545454544
806012,Taishi Nakawake,427,273,61,733,271,112,1160,544,173,0.4689655172413793,0.3180147058823529,0.14913793103448275,0.36810344827586206,0.639344262295082,0.22344322344322345,0.631896551724138,0.36971350613915416,0.4132841328413284
806187,Griffin Cheney,132,79,20,255,83,24,387,162,44,0.4186046511627907,0.2716049382716049,0.11369509043927649,0.34108527131782945,0.5984848484848485,0.25316455696202533,0.6589147286821705,0.3254901960784314,0.2891566265060241
806189,Andrew Keck,44,26,8,58,22,8,102,48,16,0.47058823529411764,0.3333333333333333,0.1568627450980392,0.43137254901960786,0.5909090909090909,0.3076923076923077,0.5686274509803921,0.3793103448275862,0.36363636363636365
806273,Adam Retzbach,185,115,56,269,72,35,454,187,91,0.4118942731277533,0.48663101604278075,0.20044052863436124,0.40748898678414097,0.6216216216216216,0.48695652173913045,0.5925110132158591,0.26765799256505574,0.4861111111111111
806956,Ethan Salas,82,50,7,51,12,4,133,62,11,0.46616541353383456,0.1774193548387097,0.08270676691729323,0.6165413533834586,0.6097560975609756,0.14,0.38345864661654133,0.23529411764705882,0.3333333333333333
806964,Sebastian Walcott,10,5,1,37,14,4,47,19,5,0.40425531914893614,0.2631578947368421,0.10638297872340426,0.2127659574468085,0.5,0.2,0.7872340425531915,0.3783783783783784,0.2857142857142857
807712,Luke Keaschall,49,32,5,66,22,8,115,54,13,0.46956521739130436,0.24074074074074073,0.11304347826086956,0.4260869565217391,0.6530612244897959,0.15625,0.5739130434782609,0.3333333333333333,0.36363636363636365
807713,Matt Shaw,113,76,6,179,70,18,292,146,24,0.5,0.1643835616438356,0.0821917808219178,0.386986301369863,0.672566371681416,0.07894736842105263,0.613013698630137,0.39106145251396646,0.2571428571428571
808206,Geisel Cepeda,499,257,34,985,360,74,1484,617,108,0.41576819407008087,0.17504051863857376,0.07277628032345014,0.3362533692722372,0.5150300601202404,0.13229571984435798,0.6637466307277629,0.36548223350253806,0.20555555555555555
808767,Jared Wegner,105,55,16,151,40,12,256,95,28,0.37109375,0.29473684210526313,0.109375,0.41015625,0.5238095238095238,0.2909090909090909,0.58984375,0.26490066225165565,0.3
809327,Andrew Fernandez,19,15,3,21,13,1,40,28,4,0.7,0.14285714285714285,0.1,0.475,0.7894736842105263,0.2,0.525,0.6190476190476191,0.07692307692307693
810053,Caleb Ketchup,122,76,23,138,28,13,260,104,36,0.4,0.34615384615384615,0.13846153846153847,0.46923076923076923,0.6229508196721312,0.3026315789473684,0.5307692307692308,0.2028985507246377,0.4642857142857143
811210,Kade Kretzschmar,17,11,4,16,5,3,33,16,7,0.48484848484848486,0.4375,0.21212121212121213,0.5151515151515151,0.6470588235294118,0.36363636363636365,0.48484848484848486,0.3125,0.6
812470,Joe Redfield,103,57,9,99,17,6,202,74,15,0.36633663366336633,0.20270270270270271,0.07425742574257425,0.5099009900990099,0.5533980582524272,0.15789473684210525,0.4900990099009901,0.1717171717171717,0.35294117647058826
813386,Justin Johnson,196,136,26,276,81,18,472,217,44,0.4597457627118644,0.20276497695852536,0.09322033898305085,0.4152542372881356,0.6938775510204082,0.19117647058823528,0.5847457627118644,0.29347826086956524,0.2222222222222222
813883,Ryan Ignoffo,25,22,3,41,12,5,66,34,8,0.5151515151515151,0.23529411764705882,0.12121212121212122,0.3787878787878788,0.88,0.13636363636363635,0.6212121212121212,0.2926829268292683,0.4166666666666667
815039,Dustin Dickerson,200,111,14,225,66,16,425,177,30,0.4164705882352941,0.1694915254237288,0.07058823529411765,0.47058823529411764,0.555,0.12612612612612611,0.5294117647058824,0.29333333333333333,0.24242424242424243
815755,Kevin Bruggeman,42,27,5,34,7,2,76,34,7,0.4473684210526316,0.20588235294117646,0.09210526315789473,0.5526315789473685,0.6428571428571429,0.18518518518518517,0.4473684210526316,0.20588235294117646,0.2857142857142857
